NO test_artifacts/valid.xpm
SO test_artifacts/valid.xpm
WE test_artifacts/valid.xpm
EA test_artifacts/valid.xpm
F 32,199,219
C 241,220,135

1111111111111111111111111111111111111111111111111111111111111111111111111111111111111111111111111111
1010000001000000100010001001010000000100000001000100000000000000000000000000001100000010110100000011
1101000000100000000001101000001010000011000100100010100100000100010001111100000000000001011000001001
1010100110001010001000000001000000110100000101000000000000000010100010000110011000000000100000101001
1011010000010000000100000100100000000001000100000001011000000000000000011100000101110000000000000001
1000000000000000000000001000000001110000001000000001111000001100000000100010010000000001000010001101
1010000100000000000100001100000000000100000111000000010001010000010000001000000001011001000000000101
1000001000100000000000010000000000000000000000000000000000000000000000000000010000000000001001010011
1001000000000000010000000100000010010101001101000011001001000011101000100010000000010000111000100101
1000010000000000000000010110001100000000000000100001000010000000000000010010100000010111000000100001
1000000010000100000000000000000000111011000000010001001100000010100000000000011000101001000001000001
1000000001000001000100010000000100010000100100000100001000000000000100011000000010001011000000000001
1101010000000110000001000000000100010000000000000000101100100000000000001000000010100000100010100001
1000011000000100000010000000100001000000000000010100100000001000001000000001000011010100011000010001
1101000000001000000000000000110101100000100000000110001101000100000000100000010000001010000000000001
1001000000001110000000010001001010000000000100110000001001000001110000001100100110110001001010000101
1111000000010000000001000000000000100000000000001001001000011000000000000001001000010001100000000001
1100011000010000001000010101000000000000000000000000000100001000000100100000000010100100000000000101
1001100000100010010010000000000101010000001000100000000001100000000010000100111001000000001000001001
1100000000000100000000000000001001000100000000000100000111110100000000001000001100000000001100000011
1001001100010010010100000000001110001000001000010000000000000000100100000000100010001000110000000001
1100010001010000000000000000000000000010000000100000110011010010000011000000001100110000000001000001
1000000000000001000000110110001001000010010010101111001000000000000001100010000101000100000100000101
1111000100110000000000000010001000011000000010000101010000000000000010010010100000001000000010100001
1000000000000011000010000100001101010111000001011001000100001000010000000100001000100001100010000111
1000000001011100000000110001001110000000000000100001110000100000000011010100100010000010000100010001
1001000010000001000000000010001000000100000001110000110000001000000000000010000000000000100100001011
1011011000001000000000000100001000001000000000010000000001000000000000010100000000001010000110000011
1000000001100000000001010000000001000000001000000000100000000001000001000000000010100101101000100001
1011000000000000000100000001000111000000000000000000101000000000000001000001000000000000010000000101
1000011000100000000000110000011000001001000000010010000000101000000001000000000000010100010000000001
1000100010000001110010000100001010000001000010000000010100101010010001001100110001000000010000011001
1100000000010000010000100000001010000000000000010001001100000000010000000010011100000100000100000011
1100001010100001000010010000000101010000100001000110001000100100001000000010100010000000001000000101
1101101000000101001001011010100000100011001000000000000100001100000000010001100000000000000010000001
1000000010000000001011010100000010000000001001001111000100000000001100110000010000100010000110000001
1100010000000000000000000100000001000000000010000011000000000000010101100000100000010000000010100001
1000000010110000100000100001000100010000010000100010000001001000010011100001011010000000010000110101
1101000000010001000100100001000000110110010110000101010011000000010000000000000000000000000000100101
1000000010000101000000011000000000000001000000100001001000000011110100000000000000011010110100100001
1000100000000000110100010100000000000110010010100100000110000000000111001000000000100001010000000001
1101000000100000010100000111000001000000001000001000000010001000100000000001000000001000000010101001
1000000000010101100111000011100000100110000000011000011000000000001000001000000101101000000110000001
1000110000010000111001010000001000000000000010000100001010000001010001000000001010100000000011001001
1100000000010000110000000000010001000001101101010101001000001011000000001000000000001000000011000001
1000010000000000001100000010100000100011010000010000001000000100000000001000100000000001000000000101
1001010000100000000011000010000111000010000000001010000010100000000001100000000000000010000101010001
1000000000010010110000000001000100001000000001000100000000000011001000000101010100011000000000010001
1000000000000100000100001000100000000011000000010001000100000000011001000110100000100000001101000001
1100010001000000100000000011100000100001100000000010000100000001000100001110010011001000000001001001
1000001111100000000001000100010000000000001000010000010000000001000000000000000010001000000000000001
1000001000000000000000010010010000101001010001000000000100010100100110010000000100100000000110100011
1000100011100000000000100000000100000000000000000000000000000111000100000000000001110001000000000001
1000001000010010010001001000000001010000000000000101000100001010000010000000000011000001000010010001
1001000101000010110100000000000010000000100011000000000000000000000000001010001001010101000010000001
1000000100000000000100000001010101000100010000000010000000000010000100001000010100000000000000001001
1000000001000000100000010001000000100000000011000000001000000100000010100000000000000000010010010101
1100000000000011000010010001000000010001000101001000000010010000000000010000000001100010100000000101
1000000110000010000000000000010000010010001001001000101100000001010001110111000000000001010011000001
1100000010001010101001100011110001001000101001100100001101100011000000000000100010100010000000000001
1000000000111000000000000001000000000000100001010011100001000000000000100000001000001010100000000101
1001111000000101010001010100001110000000101010000010101001000000000000000000000000010100010100000011
1001010000100010010001010000000001000000000010001000000010000000001000000000001010001000001011000101
1000100000000000000000111010000000000111110000010100101000000000000000010010010010000111010000000001
1101100000000100000001000000010000010000000001010101000100001000100101101000000000000110101000000101
1000001000000000001001010000000000001000100010000000000110000000000000000001000000000000100100100001
1000001101001100100010110000000100000001000000001010000000001000010001000000100100000001000000000101
1011000110000001001010000111000100000100010000000000000001000000000101000010011010010000100000000001
1010000110110000001000000101010000000000010000010000001000010000000010001000001000100000010010101001
1000001000000010010000010000100000100010100000000000000000000000001000000010001110001010000101010001
1000010000101001011000000100101000010000000000000000000000001011001010000100001010010100000000010001
1100101100010100011010100000000001000001010100000000100000010000000100100000011100010100000000010011
1000011000010000100100001001000000000000010000010000001100011000000000000100000000100000010111010001
1000000000000000000101000000100010011100000110001000110000100000000110000011000000001001000001000001
1000000000001110000010000000001001000000100000010000100000100010110010000000000000010001100001011001
1000000000100100000100000000000100001000000000001000001010010010111000100000000010000010110100000011
1000000001000000010000010000000000000000100000001001000100010000000001000000010010011000100000011011
1100000000100000000000001000000010100000100010000000001101000100000111100010001000010010001001111001
1000100000000100100000001000010001000000010000100001111000000000010011000010100000100101000100000001
1000000000000000100001001001000000011100001100000100010000000000000000010000000000000100000010100001
1001100000001000000001000000010000000110010000000000000000001000001010000000010000000000100000000101
1100000001001000010001000000001100000000000001001000001000000000000010001000001001000000000000000011
1001001000000111110101000110011000000011001000000110000000000000010000000000000011000001000001100111
1100000000110010100000111000101101100000000100100100001000000001000000000101100010100000000000000001
1000100000000100001000011001001000001000001000101000011000000101000000001000000010110000000000100101
1000000000000000001100101001100000000001000001000000000000000001000000000100100000000001000000010001
1000100011000000110000000010000000000000000000000000110101000000000000110010100000101000001000000001
1000000001010000100100000000000010000100000000000100001010000000100000101100010000000000000000000001
10100110001001010001101100000100001010000010001001001001010N0000000000010000000011000001100010000001
1001000010000000000000111000001010000000000110000000010001000000100100100000001001000011001000000001
1100010001011000001001001000001100000000010100100000001001001000001000000000001001000001100000010001
1010000100000000001000100000000100000000001000000000010000001000010110000000000111000011001100001001
1000000100000000000000000000000011000000000000001010000100000000100000001111100000011000100000001101
1001001100000000000001000000000101100001011101010001000010001001100101000011000110001000100010000011
1000010010000010001100100000000000000000000000110000010010110101100100000110010000010000101110000001
1000000100000110000000000000101000010000001000101000001001100011000001110000100000010000100000010001
1011000000010000000100000000000000100000000010100010000000000010100000000101001000000110000000000001
1000000000000100010000010000010000000000000000100000000000001100010000001000100010000011000010000011
1100000000000001100000010000111000000010000000000000100000000010000011000000000100000001100010001011
1111111111111111111111111111111111111111111111111111111111111111111111111111111111111111111111111111
