NO test_artifacts/valid.xpm
SO test_artifacts/valid.xpm
WE test_artifacts/valid.xpm
EA test_artifacts/valid.xpm
F 2,9,179
C 182,17,159

1111111111111111111111111111111111111111111111111111111111111111111111111111111111111111111111111111
1000010000100001010000001010000001010000000000011000010001010010000000000010001000000001000110000001
1100010000000000010000000000000000000100001000000000100010101000100010000000000010100000000100000001
1100000000001000000000100000000000101000010000011000000100100100100010000001000010000010000000001001
1001100010100100000001000000000000100000000011100100110001000100100000001000000000000010001000001011
1001000000010001000000001000101010011000100010000100000000000010000110000010000011100000000000001001
1010001100010000100010000000000000010001000000000010010000001000000100000000000011000001110000000001
1000010110001001010101000100010001110000010100010000000100000001001000101000101000001000100000000101
1010000011010000001000100000100000011100001000011000000100001000000001000010001000100100010000100001
1001000000100010001000100100000100000000000000000000010000000010010000000000011101010000010000000001
1000000001100000000000001000000000000010010100000100000000001000100010100000011010000010000000100001
1001010100010010000001000100000101100010001000000100000000000010000000101000001000100000000000000011
1001001001111011100000000000000000010010000100000010001000000101011000000010000001000100000100111001
1000000100001010010000000000001000001001100000010000011001010000000000000000010010001000001111000001
1010000000000010000000000000000000000000000000000111000000100001001001001000001001000000000101000001
1000110000000000010000000000010100110100000000000001010010000000000010100110000000010100000100110011
1001000000000001100100000101010000010010000001000010000010000010100000000010011000000000000010000001
1100001000011110000101100100011111000100010111000000000110100000010000000000010000000001100000000101
1110000000000010001001000010000000100000001001000011010111100010000001000000000000001000001010010011
1001000000000100000110000000000010100001000110000000011010000100000010000000110000000000101000000011
1000100000000011001010000000011110001000100000000000011100010000100000000100000000100000100000000001
1000000110100100100000001010000000000000110000000010000001000000100001101001000000000000000001010001
1011001110100010000100110100100000100000000010000100001010011000100001010000100000010000011100000001
1111000000000000001110111000000110000101001100110000100000000100011000000001000000000010000000000001
1000000000000000101010001100100100000000000100100000000010000000101000000000000000000000000000000001
10000001100001000011010100000110000010001100001001000010011000000000001101001001010000000000110N0101
1000000110101100000000000001001100000000000000111000010100000000100000000100100110100001100100000001
1010100110100100101000100001000000001000000000010000000000010000010000010000100000100110001100000011
1001100000000001000000100010100000001000100001000101000001000000000001000001110000100110100000100011
1010000001000000010010000000101001000100000000000100000000000010100001110000110010000000010000100001
1100000100101001001000000000000010011100000010000000100100000001010000000001010000010100000000010001
1101001000000000001001001000000000000000000000000000000000000010000100000010010101101000000001110001
1110000001000011000000000001011000000111001000000100001010100000001100000000000000000000010000000001
1010000010110000000000010000000000011000000110100000010000000000010000000001000000000000000000000001
1000000110110000000000010000010010001000000000000000000000100000100010110100000001000000001000000001
1000000000000011011110000010000000000000010011000001000000001001100000000000000001000000010100000001
1001000100011000000000010000000000000000010000000000010000010000010000000000000000000000001000100001
1010010000000000011000101000000100000000000001101000100000001000001000010000001000010000010000001001
1000001000100000011001100010010001000010001000000010001010010011111000001000110100100100000111000001
1100000110000100001000100001001000000000000000000001010001110100000100000000000000001010000000000011
1101010100100100001000010101000000000000110010011000000101001110000010101000100000000001011010000001
1100000000000000000100100000101011000010000110110001001000000000001111000100010000000100001011000001
1001000000000000011001010000001000000000100000010010000101010000110100001000100000000000000000011001
1000100000000000010000101000100010000100001000100000000011010000011100000000001010000000010000001001
1100000000100100000000000000001000100001000000000000000011100000000000011000100000010001010001000001
1100001010000000000000010000001001100000101010111011000010000100000000000000000000000000000000011001
1001000000000010001100010100000001000000000001001110101001000000100010000100010000110000000000000001
1000000000000000000000000001000000100000000000101010000010000000100001000000000001000000000000001101
1010000000101100110001000100000001001000100100100010000100110000001100011100010000000000011000100001
1001001100000011000100000101000100100001100000000000100010000000000010000010000000011000001001000011
1000000000000000000100001000000100001101000000000100000100001111100000000000010000000110001000110111
1000000110000001100100000010000000111000100001000000001011000000100000000000000000101000000000000011
1010010110110001100000011000100000000100101001000000000001000100000100001000101000011000010100000001
1000000000010000000100001100000000000000000000110011011100001010011000000100000000010000000100100001
1000010010101100000000000001110000000000011001110000001000000100000000000000100011001000000000000101
1000000000010000011100000000100000000001000000000110000001000000001100000000111000000000000000100001
1110011100000010000110100001010001000000000010001000000100001010010001000000000000011000010010011001
1001010001100010000000000001000001000100001111000000011001000100001101000000000101000001000000000101
1010000000001000000100000100100100100010010001110001000000000100000010000100000000010000000100010001
1000000000000010100000010000000001001000011000100000001010000010100000001000000000000000000000000001
1000010000000001100000010100000000100010000000000010100000000000010001110000101010000010000010000011
1110000010000000100010000110010000000110010000000100000010101000001011000001000101101000100010000101
1010000000001010100000000000001000000000001000000101000000100100010100000000000000010000001001001001
1000000000111110000000000100010110000000101100000000000000001100001001000010001000001100000010000001
1000000100010010000100001000000000000000100000000000101000000001000000000000001000000100100101000001
1000000001000000000010000000111000000001101010001001000100110010101010010000010000000110000000000001
1000010000000000000010000000000100000000100101101000000000100001001010000000000000100000100000000011
1000100101010000000001000000000100001001010100000010101001000000100000000000001000000001100000000001
1010010001011000100000001100000000001000000000000000101000000000000000100100100000000000000000000011
1000101000000110000000100000000000000001001000100000001000000000000001000000001000001001000100000001
1000000110110001000000000000011000011000000100000110010100000010000100000110000001100000000011010001
1000100000000010100011100000000000000000000000100000000110000000110000000110000000110010000000010001
1000000100010000000000100000101010000100100000001011000001000010000001001010000000000000010001000001
1000011110010011000000100000101001011000000000000000100010001100000000100000000000000100000000001001
1000010000100000110000000011001000001010100000100000000101000000000000010110100000000000001000000001
1000101010000000000100000000001100110000000000000000001001000000000101000000101000000001011000010001
1000001001000100001100010100000000000000010000000100000011000000111000000001001100010000100000101001
1000000100000001000000100000000000000000000000010010001000010010000000000001101000000000001011000101
1000000001100010110001000000100110000000100100111000011101000000101010100001000000000010000101010001
1100100000000001010010100000000000000000000000000000010001000100001100000000010000100000000011000011
1000000010000000000000011000000000010010011000000110000000001000100000000000000000000000000000000001
1000000100100010000010010000000001001100001000000001001000001010100000000000010100000001001000000101
1010000000000000100000100000001100011000010001001001001011000000000000000000000001000101010000000001
1000000000000000001100000001010100000000000000010000001110010000000000000000010110000100010000000011
1000010000001101011001100000101000100010010000010010001000010000001101000000011010000000000001000001
1000010000110001100100010010100000000100100100111001010010100011000000010000010000000000000000011001
1000000001001000000011000000010000100000000000000000000100100000010000000001000000000000000101000001
1010000010100000000000010010011010000000011000101000000010000000001000101000001100001101100100100001
1100100000001000000000000011001111000000010100000000100011001000110000000000000000000000000001000001
1001001000001100000000000100000100000000101000000000000000001000000001000000010000100000000000000101
1000000000001000000100000010000000000010000010100100000001000100000001000000001010001000110100100011
1000100000000010001001001000001000000010010000000100010000000001010100000010010000000000011010100011
1000100000000000001001001000010010100010100010100000000010000000000000011010000001100000000000000001
1100001100100000000000000001000001000000100111000101100101000011000000000110001000101011000000000001
1000000000000000100000000000001100000000000000010001000001000011100000010000000000000000010000010101
1000000000100000000101000000101111001011010000011100011101011000111000000100000000000001001000000001
1000000100010010001000000000010100100000000000000010000000000000100010001000111000100100000000110001
1100000000000000000000010100000001000000001001001111000001001000001010010001000100000000000000000011
1100110000000100100000100000000010000001010100000000100001000011100000000010000000000010000000000001
1111111111111111111111111111111111111111111111111111111111111111111111111111111111111111111111111111
