NO test_artifacts/valid.xpm
SO test_artifacts/valid.xpm
WE test_artifacts/valid.xpm
EA test_artifacts/valid.xpm
F 91,0,0
C 140,181,88

11111111111111111111
1X0000X0000 X00   N1
100	00 0 000000000 1
10XX000000 0000000X1
1000	0000000X0000001
100000000000000000 1
1XX 0000X0  0 000001
10X000000X0X0X0  X01
1000X0000 000000X001
1	000	X0000000000 01
10XX 0000X0 	0000001
1000000000000X00X0X1
100X000000X0X00000	1
10	000000000000000X1
10000000 000 000X0X1
1000X000000000 00001
1 00XX  0000000000 1
1000  00000000 00001
1000 	00 00X00000001
11111111111111111111
