NO test_artifacts/valid.xpm
SO test_artifacts/valid.xpm
WE test_artifacts/valid.xpm
EA test_artifacts/valid.xpm
F 168,98,114
C 81,155,216

11111111111111111111
10000000XX00000000X1
100X000000	00X	00001
100	000000 00000X0 1
1X0 000000	000000X01
10 X  0000  0 0	X	01
100000000 00000X0001
1	0 X 00000000 000X1
10000000000000X000 1
1 0X0000000XX 000001
100000 000	0X X000 1
1000000 0000X00	0X01
100000XN 00000X000X1
1	00 0X000X000X000 1
10000000  00000X0001
10 0 00000 	000 0X 1
10X0 000X0000 000001
10000000000X00 00001
1 000 0 0 0 0	000001
11111111111111111111
