NO test_artifacts/valid.xpm
SO test_artifacts/valid.xpm
WE test_artifacts/valid.xpm
EA test_artifacts/valid.xpm
F 223,189,222
C 45,236,185

11111111111111111111
10 0000	000000000001
10000000000X000 0001
10000000000000000X01
1X0 0000 00000000001
10X00000000000 X00X1
10 0 0 00000 0000	01
100X	0000000000 00 1
1X0000X	000	X0000001
1000 	0X0X00000000X1
10X0000XX  X00000001
1000000 00 00XX00001
1  000000000X0X0 	01
100X000	X00 0X00 0	1
1000000000000X0 	001
100000000000X000XX 1
1	0000 00X0 0X0 0001
100 0 0	000000000001
1000000000N00	 0X001
11111111111111111111
