NO test_artifacts/valid.xpm
SO test_artifacts/valid.xpm
WE test_artifacts/valid.xpm
EA test_artifacts/valid.xpm
F 188,185,200
C 59,204,36

11111111111111111111
10001001001000001001
10000100001000000001
11000001100010000001
10001000010001100001
10000000000000001001
10010000000000010001
10000000010011000001
10000010101000001011
11000101100010000001
10100000000000000001
10010010N00000100001
10000010001000001001
10000000010100000011
11000100010000000001
10000000010000010001
10000011000110001101
10011100000000000001
10110111001000011101
11111111111111111111
