NO test_artifacts/valid.xpm
SO test_artifacts/valid.xpm
WE test_artifacts/valid.xpm
EA test_artifacts/valid.xpm
F 144,251,148
C 194,107,80

11111111111111111111
100000000000000000X1
100	X0 0000XX0000001
1 00000X000	00000 01
1X00X 0X000X 000	001
10000000000		0X00XX1
1X0 00000 	0000XX001
1 0X00000 0000000001
10000X000000X0	00X01
10XX00X00000 00000X1
1X0000000000 XX00001
100000000000000 	001
10XX	0  000 00000001
1X00 0000N0 00000001
10X00 0 	0	 00000001
10X0000 0000	 0	0	01
10  00000 000000	X01
1000XX00 0000000	 01
10000 00000X0X00 X01
11111111111111111111
