NO test_artifacts/valid.xpm
SO test_artifacts/valid.xpm
WE test_artifacts/valid.xpm
EA test_artifacts/valid.xpm
F 4,250,103
C 185,89,22

11111111111111111111
1X0000000X0000XX00X1
10X0X0000 X0000 0001
10000000X0X000 X 001
1 000000 00X0	 000 1
100X00 0000000X00 X1
1 0 X00	 X0000 	 001
100X0X 0 0000000	001
10000000000X0X000001
1000X	0000 X000 0001
10X000 0  000000 001
1000000000 000000 01
1000X00000 00000   1
1XX	0000000 000000 1
100000000000	0000001
100000 000N000 00001
1 000 00	00 00000001
1	000000000000000001
1000000000000	000001
11111111111111111111
