NO test_artifacts/valid.xpm
SO test_artifacts/valid.xpm
WE test_artifacts/valid.xpm
EA test_artifacts/valid.xpm
F 140,7,74
C 249,13,22

11111111111111111111
10000000100000000001
10000010000100010001
10100000000110001001
10000100010000010001
10N00000000000010101
10000000000000000101
11100010101001000001
10001100010000000001
10000000100000010001
11001100001100000101
11000000011000000001
10000000010000001001
10001000000000000001
11000000000011000101
11010010000000100001
10100000000000000001
10000000000010000011
11001000000000010001
11111111111111111111
