NO test_artifacts/valid.xpm
SO test_artifacts/valid.xpm
WE test_artifacts/valid.xpm
EA test_artifacts/valid.xpm
F 119,24,17
C 131,109,57

11111111111111111111
1 00X000 00000000X01
10X 00 000000XX0XX01
10000000000 00 0 001
10000000	000	X00	001
10X00000	00	 000	001
1000 000000X00000	01
10000000 0 0 0000X 1
1000X0 X00X 00	00001
1XX0X00 0	N00	000 01
1	0X000000000000X001
1000 000	0 000000  1
1 000 0000 X0000 001
1000 000X000X0000001
10 00000X00000000001
100	 0X0	X0 0X00		01
1000 0 X0000X00000X1
1000000000X00000X0	1
100000 000000X0X0001
11111111111111111111
