NO test_artifacts/valid.xpm
SO test_artifacts/valid.xpm
WE test_artifacts/valid.xpm
EA test_artifacts/valid.xpm
F 178,206,123
C 249,20,61

11111111111111111111
11000000110000111001
10000010100000000001
10000000000100000011
10101000000000000001
1000000N001000001001
10000000001000000001
10000100000000000011
10000010011110000001
10100000000100000001
10000000000000001011
10000000001001000001
10010000011000000101
11000000010001000101
10000001001011100111
10110101100010000011
10000101000010000011
11000000000101000001
10000100000011000101
11111111111111111111
