NO test_artifacts/valid.xpm
SO test_artifacts/valid.xpm
WE test_artifacts/valid.xpm
EA test_artifacts/valid.xpm
F 230,,0,0
C 180,243,122

11111111111111111111
100000 000000	000001
1  0000000000	0X0001
10000 0X00X0 00	0001
10	0X0000X 000 0X001
1X0000X000	000 00X01
100000 0XX00XX00 0 1
100X000 000 0000X001
10 000 0000000000001
10000000X00X0 XXN001
10000000000	000 0001
1000000000X0X0 X00 1
100000	 0X00000	0001
1X 000	00 	0 0X	0001
10 00000000000000001
10000000X000X0 0  01
100000000000  000001
10X00 000000X0000 01
10000000 0000 00X001
11111111111111111111
