NO test_artifacts/valid.xpm
SO test_artifacts/valid.xpm
WE test_artifacts/valid.xpm
EA test_artifacts/valid.xpm
F 20,210,254
C 207,200,125

11111111111111111111
1000000 000000000001
1000000  000	0 0 001
1X0X000X00000000X001
10X0X 00XX00000X0X01
1	00XN000000000	00 1
1	00	0X0000000XX0001
100X0000000 0 00 0X1
100X00000000XX000001
100000000 	0000X 001
100 00000000	0000 01
10000000X0	000  0	01
1000000 0000 00X0001
100000	0	000000000 1
10 		000 00000000 01
1	0000000  000000001
10		X00 0 X0000000 1
1000000000X 0X	000 1
10000 0X0 0000000X01
11111111111111111111
