NO test_artifacts/valid.xpm
SO test_artifacts/valid.xpm
WE test_artifacts/valid.xpm
EA test_artifacts/valid.xpm
F 177,226,213
C 22,81,141

11111111111111111111
10 0000000000000X001
10000 0 00000X 00001
100 0000 X 00X000	01
10000X00000	000	 001
1X00000000000000X001
10 000X0X0000000	 01
100	0	000 000X000001
1 00 000 0X000	000 1
1 0 0000  	X0X000001
10000000 0   0000001
1	X0 00000000 0 0X	1
100X0X	 000	0000	0 1
10	0000 0000 0000X01
10000 	 000	0000X 01
1000	0	000000 000001
1 XN00	000	000X00001
10000X00 00	00000001
10000 0 0000000X0001
11111111111111111111
