NO test_artifacts/valid.xpm
SO test_artifacts/valid.xpm
WE test_artifacts/valid.xpm
EA test_artifacts/valid.xpm
F 52,155,17
C 98,194,122

11111111111111111111
10000000000000X0 	X1
10000000000000 0X001
10000000 X00	0000001
10000  0000000 0X0X1
1N00	X0X00	000000 01
10000000 00 X000X001
1	0 0000000  000 001
10000000X0000X000X01
10  00 00000000	0	01
1000000	 0X0	00		001
1 	000X 000000000001
10  00X0 00	000X0001
10 XX000000X000	 001
10X000X000 X00000 01
100	 00 000000X0X001
100 0	000000X0		0001
1000 000000000000001
1X0X000 00000 0 00 1
11111111111111111111
