NO test_artifacts/valid.xpm
SO test_artifacts/valid.xpm
WE test_artifacts/valid.xpm
EA test_artifacts/valid.xpm
F 171,12,146
C 240,196,225

11111111111111111111
11001001100001000001
10000000010000000001
10N01000000000000001
10000010100000100011
10000000000100000101
10001000100001000001
10000110000010010001
11100010000011010001
10000000000000101001
11010000000000111111
11000001110101010101
10110000000000000001
10000000000000010001
10110000100000000001
10000000100101011101
10010000000001000001
10000000000000001011
10011110000010010001
11111111111111111111
