NO test_artifacts/valid.xpm
SO test_artifacts/valid.xpm
WE test_artifacts/valid.xpm
EA test_artifacts/valid.xpm
F 55,96,111
C 133,58,47

11111111111111111111
1X 0 X000X0 X000X0	1
1000000000X000X00001
1	00000000X X0	 0001
100	00 000XX00X	X001
1 00X0 0  	00X000001
1 0	0X000000  000001
1 00000X 00000000001
10 00XX000X0000000	1
100X00000 00X 000001
1000000 00X000000	01
100 0X00000000X000 1
1000	00000X 00X00X01
10	0	000X0X 00000001
1X00  0 000000X0X0X1
1 0000N00X0000000 01
1	00XX000X00 X000001
10000X00	000 000  01
1X00000  0000000 001
11111111111111111111
