NO test_artifacts/valid.xpm
SO test_artifacts/valid.xpm
WE test_artifacts/valid.xpm
EA test_artifacts/valid.xpm
F 224,197,233
C 118,140,31

11111111111111111111
1	 0 X00 00000X 	001
10000X  0000X0000X01
10	X0  0 0 000 00001
1000000000 X0000X 01
10	000X 	 0000000001
10	0	000000000000X01
100000000X	 0000 001
1 0000000 0	0  00	01
100	XX	0000000000	01
10000 00000 0	0000 1
1XX0 0000X000000X001
100X   0000	00000001
1X000 000N00	000 001
100 0X000000000X0	01
10000X0X000	00 X0001
100000000 X0000 	001
1 0 0  X00000 000001
1 0	 00X0000000X0X01
11111111111111111111
