NO test_artifacts/valid.xpm
SO test_artifacts/valid.xpm
WE test_artifacts/valid.xpm
EA test_artifacts/valid.xpm
F 27,250,145
C 8,249,82

11111111111111111111
10101000000101000011
100100N0000101010011
10001000100010010011
10000100000000110001
10001001100000100001
10000000000000000101
10000000000010000001
10010000001011000011
10001100111000001001
11000000110000001001
10001010000001100101
11000101000101010001
10100000001000000001
10100001000000001001
10000000001000110101
10010001000000000001
10000101010100010001
10110001001000110011
11111111111111111111
