NO test_artifacts/valid.xpm
SO test_artifacts/valid.xpm
WE test_artifacts/valid.xpm
EA test_artifacts/valid.xpm
F 101,205,22
C 20,97,30

11111111111111111111
10110100000001000001
10010001101000010001
10000100001000000001
10000000001000100001
10000000000000000001
10110000000001010001
10000111000111100001
10000001000000000N01
10001001000001000001
10101000011100101001
10000010000010010001
10010100000000100001
10010000010000000001
10010001001000100001
10000000000000000011
10100000001001011001
10000000000000100001
10000000000000000001
11111111111111111111
