NO test_artifacts/valid.xpm
SO test_artifacts/valid.xpm
WE test_artifacts/valid.xpm
EA test_artifacts/valid.xpm
F 44,217,209
C 73,203,146

11111111111111111111
10 0 00000X000000001
100000000 	 X00X00 1
1 0	000000000X000001
1X00 000000X00X0X001
1000	0 0000000000001
1	0000X00	000XX	0 X1
10X0X000X00	0000X0	1
10X	000	000000000001
100 00	000000	0000 1
100 0000X0XX000000 1
10000 000 00X  X0001
1X000X00 	 000000001
1	00X0000000	00000 1
1X0000000 X000000001
10000   0000X0000001
1000 000000000000N01
10000000	0X000000001
10	  X00000000 	0	01
11111111111111111111
