NO test_artifacts/valid.xpm
SO test_artifacts/valid.xpm
WE test_artifacts/valid.xpm
EA test_artifacts/valid.xpm
F 35,0,0
C 50,211,80

11111111111111111111
1X00X00X00 X0000 001
1		000 0X00 0X000001
10000000 00000000001
10X00 00X00000000001
100	00 XX0000X000001
1000000	0000000N0001
1000X00000 000000001
1000000000	X000 0001
10000000000 0X0	0X01
10  00X0 000000000 1
1	 0X 00 0000X000001
10 0  000X	0000	0 01
10	000	000000 00X001
1000	0X00000 	000001
1000000000	000	 00	1
100X000000X00000 X01
1  00000 00000X00001
10000X0XX	0	000000 1
11111111111111111111
