NO test_artifacts/valid.xpm
SO test_artifacts/valid.xpm
WE test_artifacts/valid.xpm
EA test_artifacts/valid.xpm
F 211,159,245
C 182,68,7

11111111111111111111
10000000000	0000 001
100000 00 	00N 00001
100000000X0X00000001
10000  000	 00000001
10000000000000000  1
1 00000  X0000 000X1
1 00 00000X000000001
100000000X00 X000001
1000 00 X00 000 0001
10000000000000000001
10000 00	0000X	00001
1XX000000X	0000X0001
1000 X00	00000000001
10	 X0 0000000000001
10000 X0 0000 000001
100XXX000X0	0 0X0001
10000 0000X 000XXX01
1X000X0 000000X00001
11111111111111111111
