NO test_artifacts/valid.xpm
SO test_artifacts/valid.xpm
WE test_artifacts/valid.xpm
EA test_artifacts/valid.xpm
F 146,125,251
C 11,163,93

11111111111111111111
10000000000000000101
10110000000000010101
10000001100000001001
10011010000100000001
10011101010000011001
10000000000000000001
100N0011000000000001
11000000000010100001
10001001000000100001
10000001000000000001
10010001001001101001
10010000010000000001
10000000000000000001
11000010000000000001
10000000010010000001
10000000000000110001
10000010000000000001
11000010110000100001
11111111111111111111
