NO test_artifacts/valid.xpm
SO test_artifacts/valid.xpm
WE test_artifacts/valid.xpm
EA test_artifacts/valid.xpm
F 140,211,92
C 199,43,171

11111111111111111111
11010000001100000001
10010110000100001001
10100011000000000001
10000000001010010001
10000000000100100001
10100000001011000001
11000001011000000001
10000001000010000001
10N00100010110001001
10000000000011000011
11000000000000000001
10000111010001100001
10000011001001000001
10000000000101010001
11100000000001000011
10000010000011000001
10110001001000000001
11000000001000000001
11111111111111111111
