NO test_artifacts/valid.xpm
SO test_artifacts/valid.xpm
WE test_artifacts/valid.xpm
EA test_artifacts/valid.xpm
F 64,230,120
C 245,5,249

11111111111111111111
10000000100010100001
11101000000000000101
10000101000101010111
11100001000000001101
10010000000010000101
10000000000000100001
10010001001000100111
10000101000111100001
11000000000010010001
11000000000010010101
10000101000110000001
10010000000100001001
10000000010001010001
1000100N000100000001
10100000000101000001
11000000011000000001
10000000101001100101
10100000110000000001
11111111111111111111
