NO test_artifacts/valid.xpm
SO test_artifacts/valid.xpm
WE test_artifacts/valid.xpm
EA test_artifacts/valid.xpm
F 48,,0,0
C 33,210,99

11111111111111111111
1000000000N0000X00X1
10	0000X00000000 001
1000000X 0000X000001
1 000 00 0X000X000X1
1 00000000000000 001
1	000X00	00000000001
10	00	XX0 0 X000	001
10X0X0	000 000 00001
1X00000000000X000	 1
1000X	0000X000000001
10000000000X0 0	X001
1	00 0	000000000X001
100000000 0000X000X1
10000X00	00X000 0001
1 0 00	0	00 0 000X01
1000 0000	X000000X01
10000000 00	00X 0001
1	0 000000000 000  1
11111111111111111111
