NO test_artifacts/valid.xpm
SO test_artifacts/valid.xpm
WE test_artifacts/valid.xpm
EA test_artifacts/valid.xpm
F 27,155,40
C 226,150,31

11111111111111111111
10001000100000000011
10000000010001001101
10N00000100000001001
10000100000010000101
11000000010001001011
11110001000000010011
10000000000000000001
10100010100000001011
10101101000100000001
11000100101101010001
11000000000000000011
10000000100000101011
10111000100011010011
10011100000010000001
10101101101010100001
10100000000000101001
10001000100010011001
10101010001000000001
11111111111111111111
