NO test_artifacts/valid.xpm
SO test_artifacts/valid.xpm
WE test_artifacts/valid.xpm
EA test_artifacts/valid.xpm
F 164,79,189
C 158,30,186

11111111111111111111
100000000	0 000000	1
1X0000000000000000 1
100X000000X0X	  00X1
10000000X0X0000 0001
1000X0 000 0	0000001
10	X00000 00XX0000X1
1 00000X0	0 00X00XN1
1000	0	00X0X00000001
1000000X00000000X001
1X0	00X	0 00X 0X0001
100 0000X000000000X1
10000 00000X00 00001
10000X0X	00	0X0 0X01
100 00000000X000	001
100 	  0000X00000001
10000	000  00X0000 1
1000X00000000	0 0001
1 0 0000 0X 0 	 00	1
11111111111111111111
