NO test_artifacts/valid.xpm
SO test_artifacts/valid.xpm
WE test_artifacts/valid.xpm
EA test_artifacts/valid.xpm
F 174,53,78
C 66,221,168

11111111111111111111
100000000  000000 01
1 0X	00	000000 	0001
100 00X00000000000 1
1 0 000  000	000  01
1	X00000000000000 01
1 X000000X0000000  1
10X00000 XN00	000001
1 0X  000000 0 000X1
10000000000	00X000X1
10 000 0000000000001
1X000000000000000001
100 X 00000 00000001
100 0000X0	000000001
1000 000X0	00 0 0 01
100 000000	00000X 01
100000000000 0X00	01
1000000	X	0000000 01
1 0 00000X0 0 00X001
11111111111111111111
