NO test_artifacts/valid.xpm
SO test_artifacts/valid.xpm
WE test_artifacts/valid.xpm
EA test_artifacts/valid.xpm
F 198,139,178
C 196,34,196

11111111111111111111
10110001010000000001
10000000000000000101
10100100000100010001
10000000000010001001
10001000010001000011
1001000000000000N001
10000000001001100001
10011000110001000111
10000010100000000001
10000100000010000101
10001000000000010001
10000000000010000001
11010010000000010101
10000000011010110011
10001010000000001001
10010000000000100001
10000011100000001111
10000000000000000001
11111111111111111111
