NO test_artifacts/valid.xpm
SO test_artifacts/valid.xpm
WE test_artifacts/valid.xpm
EA test_artifacts/valid.xpm
F 23,22,177
C 26,214,97

11111111111111111111
10110000010100001001
11000110010100000101
11001100000001000011
10000000101001000001
10001000000010100101
10000101001000110111
10000000001100000001
10100000000000010101
10010001000110000101
10001010000001000101
10010010000111000001
100001000000000N0101
10000000010010000001
10010000000000010001
10000000000000100001
11000000001000001011
10000100000001010001
10010001000100000001
11111111111111111111
