NO test_artifacts/valid.xpm
SO test_artifacts/valid.xpm
WE test_artifacts/valid.xpm
EA test_artifacts/valid.xpm
F 90,85,33
C 218,171,24

11111111111111111111
10000000000000000101
11000011000000000001
11000000010000000001
10001011001000000001
10000001010001000001
10101100000000010001
10000000000100010001
10000100000001001001
10000000100000000011
10110001000000000001
10000100000101000001
10010100000000000001
10000000001000110101
10100000000100100011
10100000100000100001
11000011011000000001
1101000000000000N001
10000010000001000001
11111111111111111111
