NO test_artifacts/valid.xpm
SO test_artifacts/valid.xpm
WE test_artifacts/valid.xpm
EA test_artifacts/valid.xpm
F 130,78,57
C 53,128,176

11111111111111111111
10000000000000000011
11100010001000000001
11001010110100000001
11000000000100000001
10000100000000100101
100N0010010000000001
10000000000000000001
10000001100000000001
10000110000000000011
10000100010000000001
10100001000010001001
10010000011010000001
10000100000001000001
10010000001010000011
10010010000011000001
11000000000000010001
10000000000000000001
10000000111010000001
11111111111111111111
