NO test_artifacts/valid.xpm
SO test_artifacts/valid.xpm
WE test_artifacts/valid.xpm
EA test_artifacts/valid.xpm
F 21,,0,0
C 185,13,143

11111111111111111111
100000000000000 0001
1XXXX 000X	0000X0 01
10 0	X0	00000XX00001
1X0000X 00	0000 00 1
100000000 X0000X0 01
100000000000	00 	001
1000	0X0X0000X00 0X1
10 0 0	0000000000001
1	0 0X00 0000X000 01
10000 00 0000000X001
1000000X  0000000001
100 00	0000 00000001
100 000 0	00 0X00001
1X0000000	0000X000 1
10XX000000X000000	01
100 0  00N00 0000X	1
100 00 00X	 0000 0X1
1  0 0000	0X0X0X	001
11111111111111111111
