NO test_artifacts/valid.xpm
SO test_artifacts/valid.xpm
WE test_artifacts/valid.xpm
EA test_artifacts/valid.xpm
F 158,224,93
C 140,207,38

11111111111111111111
10X0000 00XX0X000001
10 000X000000000 001
1000 000	0X000XX0001
10X0000 000X00000 01
10 000000 00XX00 0X1
1000X000000000000 01
1 00	0 XX000XX000 01
100000000X00	0 X0001
1X000 000	 000X000 1
1 00000000000X000 01
10XX0N000000000	0 01
1X0X0000X00000000001
10X	X0000XXX000XX001
10000	000000000 00 1
100 0	000000000	0001
1000000000X00 0X00	1
100000X 000 X0000001
10	00000000 0	0 0 01
11111111111111111111
