NO test_artifacts/valid.xpm
SO test_artifacts/valid.xpm
WE test_artifacts/valid.xpm
EA test_artifacts/valid.xpm
F 182,0,0
C 39,50,168

11111111111111111111
100	0000000X0000X001
1X0X0000000X000 0001
1X0000000X00	 000001
10X00000X0000000X001
10000000000000 X0X01
1X000 0X	000000 0001
1000000000X0	000	  1
10000000	00000X000X1
1000 0 00000000000	1
1X0000000X X0X000001
10X0000000000000	 X1
100000000N0000000001
100 0 0000000 X00	X1
1000000 0 0000000X01
10000000	000X0000001
10 0000 X00X000X 001
1000000000000X0X0001
1X0X0	  0X0000X00001
11111111111111111111
