NO test_artifacts/valid.xpm
SO test_artifacts/valid.xpm
WE test_artifacts/valid.xpm
EA test_artifacts/valid.xpm
F 10,82,133
C 110,188,15

11111111111111111111
11000100100000000101
10000001110000000001
10000100000000000011
10010001001010100001
10000001001001000011
10000011000010010001
10000010100000010001
10000001110000010011
11000000000010001001
10000000000000000011
11100000000001000101
11000000000000000001
10100011000010000001
10000011000000000101
10000001001000110101
10000010000001101001
1000010000N000010001
10000001000000010001
11111111111111111111
