NO test_artifacts/valid.xpm
SO test_artifacts/valid.xpm
WE test_artifacts/valid.xpm
EA test_artifacts/valid.xpm
F 11,60,94
C 157,31,5

11111111111111111111
10010000100001000011
10000000000000000001
10000000010011000001
100N0000000110000001
10000001001000000101
10001000000000001001
10000010000000000011
11010100000001000001
10100100000000000001
11000100010110000001
10000000001000101001
10000000100000000001
10000100000011001101
10111000010000001011
10000010000010000001
10010001010000001011
10110000001000010001
10000010000000000001
11111111111111111111
