NO test_artifacts/valid.xpm
SO test_artifacts/valid.xpm
WE test_artifacts/valid.xpm
EA test_artifacts/valid.xpm
F 188,23,171
C 13,110,213

11111111111111111111
10001001010000001011
10000000000110000001
10100110000001000001
10000000000000000101
10001000000000010001
10010001001010000001
11000000010000010001
10000000000000010011
110010010000N0101011
10000100000000001001
10000001110000001001
10011000000010000001
10010000011000101001
10000010000000000001
10000000101101000001
10000000000000000001
10011001001000001011
10000101000001000001
11111111111111111111
