NO test_artifacts/valid.xpm
SO test_artifacts/valid.xpm
WE test_artifacts/valid.xpm
EA test_artifacts/valid.xpm
F 54,0,0
C 213,254,227

11111111111111111111
10 00X 	00 0000000 1
1000 00000000000X001
1000000X0000 0	00001
10000XN00 	0	0X000 1
10	00000000000000 01
10X0000 00	000000001
1000X X000	X00X00001
1000000 00000X		0	01
10 00000000000000001
1 0000000	00000 X 01
1000 0000X0 0X0 0001
1000000000000X0000 1
1000  0 0000000 0001
1X000000000 X00X0X	1
100000X000 00000	 01
1 00X0000000X000X001
10X00000000	0X000001
1	000X000	00XX 00001
11111111111111111111
