NO test_artifacts/valid.xpm
SO test_artifacts/valid.xpm
WE test_artifacts/valid.xpm
EA test_artifacts/valid.xpm
F 94,173,21
C 229,157,163

11111111111111111111
100000X000	XX0000001
10000X000000000X00	1
1000	0000 0 000XX001
100X 0X000  0N000 01
1X0X0 000000000X	001
1	 00000000X0 000001
10	X0000 X00000000	1
1000000000000000 001
1 00000	0000 X0000X1
10X000XX000000000		1
10 000000XX000000001
1	000 X0X0XX00000001
10X00000   0	0000001
10000000000000000001
1XX00X0X 00000000 01
1000000000X000000001
100000 00X0X0	0X0001
10 00X00 000	 000001
11111111111111111111
