NO test_artifacts/valid.xpm
SO test_artifacts/valid.xpm
WE test_artifacts/valid.xpm
EA test_artifacts/valid.xpm
F 64,33,248
C 117,160,86

11111111111111111111
10001000000000001001
10000001100000010001
10101010000110000001
11100001000100000001
10001000011000000101
10000010000000000001
10000000010010000101
11000100100000010101
10000100010000001001
11000000010100001001
10100001000000000001
10000000001000000001
10000000000010000011
11001000010010000011
10101000000000000001
1100000110000N000001
11000010001100010011
11000011000001001001
11111111111111111111
