NO test_artifacts/valid.xpm
SO test_artifacts/valid.xpm
WE test_artifacts/valid.xpm
EA test_artifacts/valid.xpm
F 6,223,234
C 52,98,71

11111111111111111111
11010101000110001001
10100000000010100001
10000000000000000001
11100000001000001101
10000100001010110101
10010000000000010011
11000000000000000001
11000001100000000001
10001000000100000101
10001000000001000001
10000000010000110011
10N00000000000000101
10000000000000000101
10101100000000001101
11011001000000001011
10000000000100001001
10001001100000000001
11110000000100000011
11111111111111111111
