NO test_artifacts/valid.xpm
SO test_artifacts/valid.xpm
WE test_artifacts/valid.xpm
EA test_artifacts/valid.xpm
F 169,0,0
C 106,181,174

11111111111111111111
10	00000X000 00000X1
10 0 00 0000 0000001
100000 0000000X00  1
100 000 000000X00 01
100 	000000000000001
10 00000000 00000001
1000XX	0X00000000	01
10	X	00X000 	  00001
100000 000X0 000X001
1000000 X0X 0 0XX001
10	00X00   X000000 1
100000N0	0000X0000	1
10000000 	 0XX000001
100X000X 00000000001
1000X000	0X 000X0001
1000000 00000000X001
1000000000X00X000001
100 X00000 000000001
11111111111111111111
