NO test_artifacts/valid.xpm
SO test_artifacts/valid.xpm
WE test_artifacts/valid.xpm
EA test_artifacts/valid.xpm
F 66,183,33
C 15,27,29

11111111111111111111
1X0X00000 00000X0001
10000	000X 0000X0 01
10X00 0000	 X0	0	0	1
10000000 000000X 001
10 00X000	0		0X00001
1	000	0 XXX0  00  	1
10 000000X00 	000001
10000000 000X00	00 1
1 00 0 0 000X00000	1
1 XX0000XX0000000X01
100000000X0 00	000X1
1000000000 0X00N0001
100X0000	00000 00	X1
10	 000X000 00000001
1	0X0X00X00000000X01
1000000X0 000 000001
1 0000000X00000000 1
1X0   000 0000	0X0 1
11111111111111111111
