NO test_artifacts/valid.xpm
SO test_artifacts/valid.xpm
WE test_artifacts/valid.xpm
EA test_artifacts/valid.xpm
F 65,139,116
C 249,127,19

11111111111111111111
1	000X00000 000 0 	1
1000 0 000	000000001
10 00X0000X 0000X001
100X0X0 000000 00001
10 0000X	000000X0X01
1000X000 000	000X0 1
100 00X00X00000X0X01
10 000000000	0X00001
1	00	 X000   0000001
1X00000000000 000001
10X0 00000XX0X00 0X1
1	00000000000	000 X1
10	000 000 00N	00001
100000 0X00000	00001
10		0X0 		0000 00	01
1000000	0000000 0001
1000000	X00000000001
10X000000000	 0X0001
11111111111111111111
