NO test_artifacts/valid.xpm
SO test_artifacts/valid.xpm
WE test_artifacts/valid.xpm
EA test_artifacts/valid.xpm
F 171,53,104
C 136,21,227

11111111111111111111
10000000100000001001
10001010010000001011
10000010000001000011
10000100000110001101
11000001000010000001
10000011001000001011
10000000000000001101
10100010000000000001
10000000N00000000001
11100010000000000011
11100000010000010001
10000000000000000001
10000100000000010101
10000010000000000001
10000010000001100001
10100010000000000101
10000001011000000001
10010000000010000001
11111111111111111111
