NO test_artifacts/valid.xpm
SO test_artifacts/valid.xpm
WE test_artifacts/valid.xpm
EA test_artifacts/valid.xpm
F 175,199,117
C 121,156,203

11111111111111111111
10 000 0X000000 0001
10  00000 	000X00	01
10000000 	0	X0X00001
100 00 0000000	X	001
10	0XX00000000000001
100 000 0X0 X0 0X001
1000000000X0 0000001
100	0 0 0000 0000X01
1000 000	00X00000001
100  000  0 000XX001
10000X000000	  0	001
1 00	00000  	X00 001
10000 00000 XX00X001
10X000 0 0000 000X01
1X	00	00X00000000001
10000X00X0000000X001
100000	0X00  0N 0 01
10X00X000 X00 00 001
11111111111111111111
