NO test_artifacts/valid.xpm
SO test_artifacts/valid.xpm
WE test_artifacts/valid.xpm
EA test_artifacts/valid.xpm
F 253,81,126
C 107,119,74

11111111111111111111
10XX0000 000000 0	X1
10X00000X0000000 001
1000000000 00	0X0001
1X000X0X0000 0000001
100 00	0 000000 0001
10000 X0	0	000000001
1 0	00X0000X00X000 1
10000N	000	000000X	1
100	00 00000 0000001
10 00000000 00000	X1
1 0000X000X0000X0001
1000000000000	000001
1	00000000X 00000X01
10 00000000X000X0001
10  0000000	000	0001
10000	000 000 0000X1
10X0X0	0000 000000X1
1000		00X0 000 00  1
11111111111111111111
