NO test_artifacts/valid.xpm
SO test_artifacts/valid.xpm
WE test_artifacts/valid.xpm
EA test_artifacts/valid.xpm
F 12,185,233
C 173,239,6

11111111111111111111
10 00 000000000000X1
100000 00X0 0XX0X	01
1X0 00000X X 0X 0001
10000000	0X  000X001
100 000000000X000001
10000X0	0 00000XX  1
1X0 0000X00XX0	00001
10000 0X	00000000001
10	 00X0	00000000 01
1X000000000X0000 001
10 000000N00 0000001
1	 0X00 X00000000001
100X0XX 0XX000000001
10  XX000 00000 0001
100X0000000000000001
100000000000000000X1
1000000 00 00X0000 1
100X 0 00000X00X0	01
11111111111111111111
