NO test_artifacts/valid.xpm
SO test_artifacts/valid.xpm
WE test_artifacts/valid.xpm
EA test_artifacts/valid.xpm
F 118,139,39
C 47,83,197

11111111111111111111
10000011000000010001
10000000000001001011
10000001000101100001
10000000000000000001
10000100010000001001
10000000100000000011
10000000111001010101
11001010010100010011
11010000001100000001
10000001000000100001
10001100100001000101
10100010000010000001
10000000011000000011
10000000100010010001
1000000000N000000101
10100101100001100101
10100001001111000001
10000000001000011001
11111111111111111111
