NO test_artifacts/valid.xpm
SO test_artifacts/valid.xpm
WE test_artifacts/valid.xpm
EA test_artifacts/valid.xpm
F 11,84,4
C 160,22,19

11111111111111111111
10011001110110100101
11100101001000101111
10001000000001110101
10010101001100001101
10000100000000000001
10N00100001011000011
10000001000010000001
11000000010000010111
10010000000001000011
10000010000100000011
10000000000101101001
10000101110001000001
10001000001100001001
10000000000000000101
10010000000000100001
10000000000000000001
10000100100101100001
11010000010000100001
11111111111111111111
