NO test_artifacts/valid.xpm
SO test_artifacts/valid.xpm
WE test_artifacts/valid.xpm
EA test_artifacts/valid.xpm
F 139,8,101
C 255,231,223

11111111111111111111
10100000000000000001
10100010110010000101
10000000000010000001
10000000010000N01011
10000000000000001001
10000001000010010001
10000001000001001001
11001000100010010001
10000000000001001001
10100000110000001011
10000000000011010011
10001010000000000001
11001011000100000101
10000000000000010111
10110001100000010001
10001100000110010001
10000100000100000001
11000000000100000101
11111111111111111111
