NO test_artifacts/valid.xpm
SO test_artifacts/valid.xpm
WE test_artifacts/valid.xpm
EA test_artifacts/valid.xpm
F 144,235,148
C 159,16,175

11111111111111111111
1 0 000X00 00	000001
100X00X00000X00X0001
10X00 0		000000 X001
10000	00	0	0 X000 X1
10000 00000000000001
1000000000X000	0 0X1
10000X 0000000	0   1
100	00000X000000X001
1  0  00XXXXXX00X 01
1000 0XX000000 00 01
10 00000000 000 0	01
100 0000X0	000000X01
1	00000X0 000  0	001
100 	 00000  	000X 1
10X 000X000X0	0X00 1
1N0 00000000X000	001
100000000X0000000  1
1 000	00X0000 X00001
11111111111111111111
