NO test_artifacts/valid.xpm
SO test_artifacts/valid.xpm
WE test_artifacts/valid.xpm
EA test_artifacts/valid.xpm
F 129,29,248
C 255,157,143

11111111111111111111
100000X0000000000001
100X00000  X0X00	0X1
1 0X0X0000X00 0X0001
10	 000 00	X0		00	01
1000000XX0 000000001
10000X000000 0000001
10	0000000000 000 01
10000000 0000 0 0001
1000	00000000X000001
1000000000 00 00X001
10000N000000 000X	X1
1000 X00	0X	  00 001
100000000 0000X00X	1
1 00 0X0000000X0 001
1 0000000000000	0001
10X00000000000X00001
1	X00000000000000001
1000000X0X000X000001
11111111111111111111
