NO test_artifacts/valid.xpm
SO test_artifacts/valid.xpm
WE test_artifacts/valid.xpm
EA test_artifacts/valid.xpm
F 246,126,69
C 180,68,77

11111111111111111111
10 00	 000X00000	001
1000 000 X00 00 	001
1000000000XX 0000001
1000N000X00XX000X001
100X00X0X  X0X 00001
1000000000	0 0000001
1000 00 00000	000001
1X00000000X0000	X0X1
1X00 00 	X0 00 00X01
1000000X0 0000  	 01
100000000 00 000X001
100	0000X000000000	1
10000X000000000000 1
10	0X0000000000 0 01
1	00X0X00000000 0 01
1	00000000000 00X001
1 0 X000000X0 000 X1
1	000	00	00X00	0 001
11111111111111111111
