NO test_artifacts/valid.xpm
SO test_artifacts/valid.xpm
WE test_artifacts/valid.xpm
EA test_artifacts/valid.xpm
F 79,130,148
C 176,110,50

11111111111111111111
100	0000000000000001
100000X0000 00  00 1
10 0	00 0 0000000X01
10	00	0X000	00	00001
1000 00000000		00001
100X00X00000X000 XX1
100 000	000000 00001
100000000 00	0000 01
10000000000000000001
10000 0 000 	0		0	01
1 000X0000000	00	001
1X0000000	 0000 0001
1000	 00000X00 00001
100	00X0000X 	0X00 1
1 0	0X00000000N000	1
100X	0000 0 0000X0 1
100	00000X 0X000	X 1
100X	0	00X000000X001
11111111111111111111
