NO test_artifacts/valid.xpm
SO test_artifacts/valid.xpm
WE test_artifacts/valid.xpm
EA test_artifacts/valid.xpm
F 120,212,206
C 142,74,182

11111111111111111111
10010110101001100001
10000010011010000101
10100000000011000011
10100001010100000011
10100000000000001001
10000100000000000001
10011001000001101101
10000100010000010001
10000000100100101001
100N0010000100101011
10000000000100000001
10000000010011000001
10000100000000000001
10010000010000000011
10000000000010000001
10101100100100000001
11000001100000000011
11100000000010101001
11111111111111111111
