NO test_artifacts/valid.xpm
SO test_artifacts/valid.xpm
WE test_artifacts/valid.xpm
EA test_artifacts/valid.xpm
F 104,38,109
C 12,178,161

11111111111111111111
10000001100000110001
10011110000000001001
10100000000000000001
10001100000000000101
10000000000010000001
101111000000010N0001
10000101000000000001
11000100101001101001
10010000000010000001
10000110000000000101
10000000001000010001
10010000000010110001
10010001001000100011
11001100000000011001
11010010000011001001
10000010000010000001
10000000010100000001
11100000000100000101
11111111111111111111
