NO test_artifacts/valid.xpm
SO test_artifacts/valid.xpm
WE test_artifacts/valid.xpm
EA test_artifacts/valid.xpm
F 184,46,24
C 190,97,112

11111111111111111111
10000 000X0000000001
1000X0 000000X 00001
10 000000X00000000	1
10000 00 	 0XX000		1
10	0000000 00 0 0X 1
1000X00 0000 0000001
10	0000 000	00000001
1000000 000000000 01
10X000000 000 000X01
100X 0000	0000X00XX1
1000000000000 X00	01
10	00		X0000000	0 X1
1X000X00000000X0 001
10000000000000X00001
100 000 0000000000 1
1XX	000X000  X000001
10X00000000N00000001
100	00 0000000000 	1
11111111111111111111
