NO test_artifacts/valid.xpm
SO test_artifacts/valid.xpm
WE test_artifacts/valid.xpm
EA test_artifacts/valid.xpm
F 44,208,36
C 112,181,47

11111111111111111111
10000010000000100001
10000010000000000001
10N00100000000000101
10000001010000001001
10010000000010010101
10001100100000010001
11000000000100001001
10000000001001001011
10000010000000101001
10011000000000011001
11100000100000000101
10110000000000000001
10000000010000000011
10100001001100000101
10001000001000010101
10000000000110000001
10001010001010000001
10000000000000000011
11111111111111111111
