NO test_artifacts/valid.xpm
SO test_artifacts/valid.xpm
WE test_artifacts/valid.xpm
EA test_artifacts/valid.xpm
F 72,16,119
C 108,232,62

11111111111111111111
10000	0000X0 0000001
10000X0000000X000001
1000X000000	00000001
1000 0X 	 00 00X0001
100000000000000000X1
1  0000000000000 X01
10X000000000000 0	 1
1000000000 000000001
100X0000	X	000000001
1000000000 00000X0	1
100  00 000X000	0001
1XX000 0  0XXXXX 001
1 	 X0X0 0	0X000X0X1
10 0	00000000X	00001
10000	0000000000 X01
100000000000	0000 01
100	0 000000 X0XXX01
10000	0000	N0 000	01
11111111111111111111
