NO test_artifacts/valid.xpm
SO test_artifacts/valid.xpm
WE test_artifacts/valid.xpm
EA test_artifacts/valid.xpm
F 77,0,0
C 79,100,24

11111111111111111111
1X000 00 00 0	000001
100000000 	000000001
1	00 0 00 0X00 00001
100X0000000000000001
10X000 00	0X000000 1
1000 00 000000 0 0 1
1 X0  000X0000000001
10000X000000 	000001
100X000000000X0 0001
1		XX0000X0000 X0001
10000X0  00  00000X1
1X00 X0X0X0X 0000001
100 X000 00000000001
100	000 00000X000001
1	0	00XX0000XX000001
100000000X000X000001
1000000 0	X00 X 0X 1
100 00X		0N0000000	1
11111111111111111111
