NO test_artifacts/valid.xpm
SO test_artifacts/valid.xpm
WE test_artifacts/valid.xpm
EA test_artifacts/valid.xpm
F 207,98,233
C 70,134,87

11111111111111111111
1	000  00000000 XX	1
100 00000000 0 X0001
10	0000XX	000 000001
100000 0000000X 0 01
1000	X0 00X0000X00X1
10000	00000000000001
1000000XX000X 000001
1000X0X000 000		00N1
1000000	00000	 00001
1X00000 00X X00XX001
10	000000	0 00000X01
1X0000000000000X0 01
1X000X0000X00000 001
100 0X0 X00	00 00001
1000000X0X00	00 00	1
1000 0000000 X00X0X1
1 0	0000X000X0000001
100X0000 000X0000	01
11111111111111111111
