NO test_artifacts/valid.xpm
SO test_artifacts/valid.xpm
WE test_artifacts/valid.xpm
EA test_artifacts/valid.xpm
F 144,28,32
C 254,148,198

11111111111111111111
10010000000000000101
10000000010000001101
10010010000110000001
10010000000010101001
10000010000000110101
10000000010010000101
11010010000100000001
10001000000010000001
11000001111110001101
10100010001000100001
10110000010000100011
10100000010001001001
10110101001100000001
11000100010100N01001
11010100100000000101
10000000100000001101
10000111000000001111
10100001000000001001
11111111111111111111
