NO test_artifacts/valid.xpm
SO test_artifacts/valid.xpm
WE test_artifacts/valid.xpm
EA test_artifacts/valid.xpm
F 68,116,212
C 243,130,141

11111111111111111111
10000001011000101001
10100001000000100001
10100011001101010001
10000000001000000101
10101000110000000001
10000110010000110011
10101000000000000001
10110011000100100001
11011000100000000001
1100010110010100N001
11000000101000000001
10000001010010000101
10010000010000011001
11011001000000100011
10000000000010010001
10000000100000000001
11000001000000001101
11100010000001000001
11111111111111111111
