NO test_artifacts/valid.xpm
SO test_artifacts/valid.xpm
WE test_artifacts/valid.xpm
EA test_artifacts/valid.xpm
F 105,0,0
C 220,138,28

11111111111111111111
1000000000	0	0  0	 1
10X000 0000 0 000001
1  000 00X000	 X00X1
10000000000   000001
100X000N00000000		 1
1X0	0000	000000000X1
10X  000000000000001
1	XX0 XX0000	00 00 1
100000000000X0 X0001
1000X00X0 0X00000 01
1X0000000 000X000001
10X00 00000X00X00  1
10000000000000000001
10000  000 000	0		X1
1X0 0 000000000	 	X1
1 000000	000 00X0001
10000000000000000X01
10000XXX 0000 X00001
11111111111111111111
