NO test_artifacts/valid.xpm
SO test_artifacts/valid.xpm
WE test_artifacts/valid.xpm
EA test_artifacts/valid.xpm
F 90,148,97
C 82,138,136

11111111111111111111
10000X	000 00X000001
1000 	X 00X	  00X001
1000 000 	00000000 1
10XX000 000000X 0001
100000N00	0X0000 001
1000  X00000000000X1
10 0000X0  000000 	1
1 00 XX0XXX000 0  	1
10X	0000 0X000000001
1000X0000XX0000X 001
1000000000000X000001
10X00	0X0000	00X0001
1XX0000 0 0X00000001
100	0000 000X00 0001
1000000000X 000000	1
10000000X	 0  0X 001
100	00 00	0 0X000001
1000 X000000000X0 01
11111111111111111111
