NO test_artifacts/valid.xpm
SO test_artifacts/valid.xpm
WE test_artifacts/valid.xpm
EA test_artifacts/valid.xpm
F 125,0,0
C 175,221,165

11111111111111111111
100 000000 0 000X001
1000	00	 0000X00 0	1
1X000X0X00 00X0 00	1
10000	XX0000000	0001
100000000X0 XX000001
100000X  000 00  0X1
1 00X00000 000 00001
100000 	000X0 0	0001
1X 0X000000 00000 	1
1000	00000 00X000001
1XX00 00N00000000001
1 0000000000000X0001
10000	X00000	0X00001
100000	000	00	0 00 1
10000	00 X00 0	0 0X1
10000 00	0X0000000X1
1000 000XX0X00	0X001
1X0X000000 000000 01
11111111111111111111
