NO test_artifacts/valid.xpm
SO test_artifacts/valid.xpm
WE test_artifacts/valid.xpm
EA test_artifacts/valid.xpm
F 52,90,228
C 62,86,154

11111111111111111111
10XX000000X000X00001
1	 00	00000000 0 001
100 0000000 	X	0X	01
100	0000000000X00001
100 X0 0	  000 0X001
1 0000	0X0X00 00		01
10000000 00X0000	001
10000000	00000000001
100000000X0 000X0N01
1X000  000    000001
1X0000	00 0000000001
1X000 0000X000	0X001
100X000000 00X000 	1
10000XX 0 000000	001
10X0	0 	000000000001
1 00 	0000		00000001
100XX00X 00000X0X001
1X00  X0X00000000 01
11111111111111111111
