NO test_artifacts/valid.xpm
SO test_artifacts/valid.xpm
WE test_artifacts/valid.xpm
EA test_artifacts/valid.xpm
F 48,2,176
C 117,93,242

11111111111111111111
11010001000000000101
10000000010000000001
10000000111000001011
10010000110000000001
10110100000000010001
10000001010000011001
10100001010100100001
10010000000010000011
11000010000000010001
10010100000000000011
11000000100011000011
10000000001101010001
10010110000100000001
10010000011000000011
1000000N000010011101
10011100000000000001
11000010100000010101
10000000000000000011
11111111111111111111
