NO test_artifacts/valid.xpm
SO test_artifacts/valid.xpm
WE test_artifacts/valid.xpm
EA test_artifacts/valid.xpm
F 192,169,149
C 128,57,80

11111111111111111111
10000 00000	X000 0 1
1000 000000 000 0001
10000000000X0 000001
100000000000000 0001
1000 0X00000000 0001
10  0000X0000X000001
10XX00000		00X0 X001
10X000 0 0X 00 X0 01
10X0000  0X	000000X1
10 0		00X000 0000001
1  0 0000X0X00000001
10000000X 00N000 001
100	0X0000 00X0 0001
1X000000 X0 0X000001
1X000 0000000 	X0XX1
100000000X00000 0 01
10X000 0000000X00 01
100000X0000000000001
11111111111111111111
