NO test_artifacts/valid.xpm
SO test_artifacts/valid.xpm
WE test_artifacts/valid.xpm
EA test_artifacts/valid.xpm
F 147,76,48
C 216,84,16

11111111111111111111
1 00000000 X00X000X1
100	0	0 X0	0000000X1
10	000000000000 0X01
100X00X00 000000 001
10	00	XX	0X00 0	0 01
1000	0	00000	 000001
10000000000X00000001
1	00X0000	0000000001
1000 00XN	X0X00X 0 1
1000 00000X000	00001
1000000X00	000000001
10 000	0000	00000XX1
100	 0 000000 000	01
10X00000X0000 0000 1
10000X 	00X000000001
1X0X0 0000	00000 001
100000	0X X 0  00001
1000000X000 000 00 1
11111111111111111111
