NO test_artifacts/valid.xpm
SO test_artifacts/valid.xpm
WE test_artifacts/valid.xpm
EA test_artifacts/valid.xpm
F 24,132,27
C 42,120,252

11111111111111111111
10	000000000000000 1
1X0000000X000X000001
1000	0	0000 00000X01
1	0XX0000000000X0 01
1000	0X0000 00000001
1X00000	X000000	0001
100	00 0 00000000001
1	000000000X0000X0X1
10000XX 000X 0000001
1N0 X00XX000 0 00001
100000000 	X0XX00001
10000000	0000XX00001
1 0000 0 000 0000	01
10000000000 00000 01
1	0X 000000000000001
10000 XX0000X0XX00X1
10000XX 0000 00X00X1
1X000	0X X0000000X01
11111111111111111111
