NO test_artifacts/valid.xpm
SO test_artifacts/valid.xpm
WE test_artifacts/valid.xpm
EA test_artifacts/valid.xpm
F 173,218,2
C 165,248,199

11111111111111111111
10100000010000011001
10010000001000000111
10000001000100010001
10000100000000100001
11000001100101000001
10000111001100001101
10000001000100001101
10000000000000001111
11000100000000000001
10100100010010000011
10000000000010001101
11100000100010000001
10100001000010000001
10000000001010000001
10001000001000100001
10101011000000100001
1001110000000000N001
10000100101000100001
11111111111111111111
