NO test_artifacts/valid.xpm
SO test_artifacts/valid.xpm
WE test_artifacts/valid.xpm
EA test_artifacts/valid.xpm
F 26,110,35
C 10,127,146

11111111111111111111
1	000000000 00X00001
100000000000XX000	01
1X00 000 00 00000001
100 00X000000000X001
1000XX000X00 0	00001
100XXX 0000000000001
10X0000 0000000000 1
1 0	000000 X0000	0 1
100X000	0000 00000X1
100000000000000X00X1
10000 000 0000 00001
100 00 000000X000X01
100 X00 0000000000 1
1	00000X00 00XX000X1
1000000	0	00 00000 1
1X0X00X0XX000X00 	01
1 00	 0000N 00000001
10 0XX000	X 0000 001
11111111111111111111
