NO test_artifacts/valid.xpm
SO test_artifacts/valid.xpm
WE test_artifacts/valid.xpm
EA test_artifacts/valid.xpm
F 240,216,1
C 242,31,221

11111111111111111111
10X000	00000	00X0001
10000 0 0000X0000001
1 000000  00X 000001
100000X00000 0X000	1
100		000000X000 0001
100 00	00000000X0001
1000X0 0X0000	000001
10 0000X0X0	0000X	01
1 000X0000X00  0 0 1
100XX0000000X 000 01
10 0X0000000XX000001
100		0000X0000000X01
1000000000000 000001
10 0X	XX000 0 0X0 01
1 00000000	00X00XX01
10000000000000 0X0X1
1X0 00000000000	X0 1
1	X000000000000	00N1
11111111111111111111
