NO test_artifacts/valid.xpm
SO test_artifacts/valid.xpm
WE test_artifacts/valid.xpm
EA test_artifacts/valid.xpm
F 245,253,204
C 187,47,72

11111111111111111111
1 0	00X0000000X00001
10000X0000 000000001
1X000000 000X00X0001
1000 0 000 000 X 001
1X00000X00X000XX0 01
1X000000000 00000001
1X00X0 0 0 00 000001
10000X00	0000	000	01
1 0	0  0	000000X0	01
1 00 00 0000  000001
10000 XX000000000X01
10X000 X0	 00 000001
100000X 00000X0000 1
100000X 0 0000000001
10 XXX00NX00000	0001
10000000000000000001
1X0X000000 000X00X01
1000X0 00X 0	0000X01
11111111111111111111
