NO test_artifacts/valid.xpm
SO test_artifacts/valid.xpm
WE test_artifacts/valid.xpm
EA test_artifacts/valid.xpm
F 37,48,189
C 195,255,131

11111111111111111111
10000X0X00X0000 0X01
10X00000X0X0000	0001
100000000000000 0001
1000 00000XX00 X0001
100000X000X000000001
1000000 0 0000000001
10 0 X000XX 00000001
1000 0X00000000000 1
1000000 00X00000 X01
100000X00000000000X1
10000N0X 0	000000001
10X000000X0000000001
100 000000X0 0000001
1000	  00	000X000001
1000 00000X00	000	01
10 0000 000000000X01
100000X0	00 00000 01
10000000 0000 00 001
11111111111111111111
