NO test_artifacts/valid.xpm
SO test_artifacts/valid.xpm
WE test_artifacts/valid.xpm
EA test_artifacts/valid.xpm
F 8,0,0
C 70,246,110

11111111111111111111
1	X  000 0 	000X 001
10 000X00	   0	00001
10X00000 000X0000001
100 0000 00NX0000001
10000000000000000 01
1XXXX00000000	0X0001
10000000X00 0 0000 1
1000	X 000X0 0000001
100	00 0XX0	00000001
10000000XX	X 0000001
100000	0 00X0	000001
10X00X 0X0 000 0X001
1	X00XX00X0 000X0001
1	00 00	000X0	000	01
1 000000X	 00XX	0001
1X00	0X000000000 	01
1 00000	0 000X0X0 	1
100000000X00000	0X01
11111111111111111111
