NO test_artifacts/valid.xpm
SO test_artifacts/valid.xpm
WE test_artifacts/valid.xpm
EA test_artifacts/valid.xpm
F 109,20,205
C 172,95,177

11111111111111111111
1000000000	00000	 01
1000000	000 0000	001
10 0000X0 0000X00001
100000XX0000000 0001
1 00000X000000X00001
1XX 0 0000  000000X1
1000	0X0000	000 0	01
100	00X 0000000	0001
1 00X00000000000X001
10000000X00X000	0001
1000X00 X0	X00 00001
1000 0 0 000000	0001
100 00000X0000 00001
1000N0000X00X0000001
1X 00000 0000	0	 001
1 	0X 000000000000	1
1000 	0000000 000  1
10X0 0000000X0000XX1
11111111111111111111
