NO test_artifacts/valid.xpm
SO test_artifacts/valid.xpm
WE test_artifacts/valid.xpm
EA test_artifacts/valid.xpm
F 71,126,83
C 49,112,78

11111111111111111111
10010100000000010001
10100100100000000001
10010001000100000011
10010000011010000001
11001000010010000001
11000001100000000001
10100000000001010001
10010000000000010011
10000000000N00000101
10000100000000000001
10000000001000000001
10000000001000000001
10000010000000000011
10100001000000101101
10000010000001100001
10001000000001001001
10000010001100000011
10010011000001010011
11111111111111111111
