NO test_artifacts/valid.xpm
SO test_artifacts/valid.xpm
WE test_artifacts/valid.xpm
EA test_artifacts/valid.xpm
F 224,0,0
C 215,131,184

11111111111111111111
10000000 X0 00000 01
10XXX000000X0X	00001
100000	000 0000X0	01
10000 	000  000	0001
10X	 000 000000X0	01
1	0X0X0000 0X000	001
100000000000000000	1
10	0000 00X 00000001
1	0 000X 0 X	00 0001
10  000000X000000	01
1X000	000000 0000001
1000 0000 NX000000	1
100X0		00	0 000000	1
10X0X   0000X0 00001
10X0X0X00	000	000001
1 000X0000000	000001
100X0	00 	0	00X0X001
10XX00X	00	0X00 0001
11111111111111111111
