NO test_artifacts/valid.xpm
SO test_artifacts/valid.xpm
WE test_artifacts/valid.xpm
EA test_artifacts/valid.xpm
F 81,139,211
C 199,230,146

11111111111111111111
11000100000000000001
10001100000000011001
1100000000000N000001
10000010100000000001
11000000010010010101
10000011100000100001
11000110010001000001
10000001100001110101
10000000100000010001
10000000001000001011
10100000110000000001
10000000000000000001
10000000001000100001
10001000000000001001
10000100000000000001
10010100001000100001
10000000100010000001
11011001100010100001
11111111111111111111
