NO test_artifacts/valid.xpm
SO test_artifacts/valid.xpm
WE test_artifacts/valid.xpm
EA test_artifacts/valid.xpm
F 129,43,136
C 254,30,131

11111111111111111111
11100010000010000101
11100000000000100011
10000100010000110001
10000100000000001001
10010001000000000001
10010110000000110101
11101001000010010001
10000000000010100001
10000000000000100011
1010N000010000000001
10100010001001000001
10010001000010000011
10000000000101101001
10000000000010100001
10001010000100010001
10000000001101000001
10010000000001010011
10000000000000000001
11111111111111111111
