NO test_artifacts/valid.xpm
SO test_artifacts/valid.xpm
WE test_artifacts/valid.xpm
EA test_artifacts/valid.xpm
F 177,0,0
C 137,216,53

11111111111111111111
10 00X 00000000000 1
1000000	0	000	X00001
100	000 00000X000001
10X000 X0	XX000  001
10	0	0 0X 0000X00001
100X0000  0 	X0 0001
100 000000 00 000 01
10X0000X0 0 X0 00001
100 0 00000X0 000X01
100	00	00X0000000001
100X00X00X0000000001
10000000	00X	0000 01
1000X000000000	00001
10000000000000000 01
10N00 0X0	 000000001
1000000  0000 000001
10 00X00000X000000	1
10X000 00000X0000	01
11111111111111111111
