NO test_artifacts/valid.xpm
SO test_artifacts/valid.xpm
WE test_artifacts/valid.xpm
EA test_artifacts/valid.xpm
F 204,147,47
C 130,235,115

11111111111111111111
10X 00000 000000	0	1
1X00000X0XX000000 X1
10000X0	00	0X000	N01
10000000X 00X00000	1
1 0X	0  0000000	00X1
100000000 0X0X0000 1
10000X0		0 00 0000X1
100 00  0	0	 00	  01
1 000000000000000001
100	00000 000 000001
1000000 X	0000 0X0X1
100X000XX	0000 00 01
10	00 X0X0X		0000001
100000000000	000	001
10000000000 X0000001
100000 0000 00 X00X1
100 0000000X0  00XX1
1000XX 0000 000 X001
11111111111111111111
