NO test_artifacts/valid.xpm
SO test_artifacts/valid.xpm
WE test_artifacts/valid.xpm
EA test_artifacts/valid.xpm
F 239,212,103
C 202,51,70

11111111111111111111
100000 0000000000001
1000000X 	0000000001
1000000X000X000X0001
10000000 00X	0		0001
1X0	0X00  X0 0X00001
1000 00000X00 	00001
10X00	0X	0 0 0000001
10000XX00		X0	 0 N 1
1000 000000000XXX001
10000000X0	00 000001
1	00000000X00X0X00	1
10 X X0	00X0 0000001
1 00 000000	0 00	0X1
10000 000 00000  XX1
1X000 	000	000 00X01
10000  	00X0000	0 01
100000000000000	0001
1 00 00X0000000X0001
11111111111111111111
