NO test_artifacts/valid.xpm
SO test_artifacts/valid.xpm
WE test_artifacts/valid.xpm
EA test_artifacts/valid.xpm
F 230,124,162
C 155,79,35

11111111111111111111
11011010000000101001
10000000000010101001
11000010000001100001
10000000001100000011
11000000000100000001
10010001000000N00001
11000000100000000001
10000100000000000001
10010010000000000001
10001000000001101001
10101000100000000001
11000100001001000011
11100000100010111101
10000000000000001001
10000010000001001001
11000000000000101001
10100000000000110011
10000000000000000011
11111111111111111111
