NO test_artifacts/valid.xpm
SO test_artifacts/valid.xpm
WE test_artifacts/valid.xpm
EA test_artifacts/valid.xpm
F 154,14,104
C 132,100,236

11111111111111111111
10010000000001010111
10000101000000000001
10001101000000000001
10000101001110000001
10010100000100000011
11000000100000001001
110100N0000000000001
10100000001000010011
10000010100000000011
10001010000001000011
10000001100000000001
11100100010000100001
10000001100000010001
11001010011001000001
10011000010000100001
10100000000101010001
10000010000000010001
11010000000000000001
11111111111111111111
