NO test_artifacts/valid.xpm
SO test_artifacts/valid.xpm
WE test_artifacts/valid.xpm
EA test_artifacts/valid.xpm
F 178,0,0
C 184,38,40

11111111111111111111
10 00000000	0X0 00X1
1X000X00000X00	00001
1X0X0000X 000 0XX001
10 000000000000 0001
1 000000000000000001
10X0000  00X00000001
1 0	00	00	00000X0 01
10X00000X00 00000001
1 000000 00000X00001
1000000 0X0000	X0	01
1	00X0X  00000000001
1000X00 0XX00 X0 001
10000	00 0	000000001
1X	00	  00	0X0000001
10X0X000 X0000000001
1000000000 000000N	1
10X0X0000X0000 X00X1
10000   X00000000001
11111111111111111111
