NO test_artifacts/valid.xpm
SO test_artifacts/valid.xpm
WE test_artifacts/valid.xpm
EA test_artifacts/valid.xpm
F 19,220,204
C 72,148,217

11111111111111111111
10100100001110011001
10100000100101000011
10101000000101100111
11000001000000000001
10001000000011000001
10100011000100010001
11001000000010000011
10111010000001000001
10000000000000010001
10000100000110000001
10000100101010000101
10000010011100000001
10000000100000000011
10001000000000000001
10100110000100000101
10111000000000100001
101000N0100100010001
11100000101000010011
11111111111111111111
