NO test_artifacts/valid.xpm
SO test_artifacts/valid.xpm
WE test_artifacts/valid.xpm
EA test_artifacts/valid.xpm
F 152,254,246
C 120,47,45

11111111111111111111
10000000 00	000000 1
1X00 00000 	X00	X001
10 000000000000	X0 1
10	00X000X 0000 X001
100000000X0	 0X  001
10000 00XX	0	0000X01
1000000000X000 00001
10 00 00000000000	01
1 00X000000000  00 1
1000000 0000 0 000	1
10X000	0 	000000 001
10000X00X  0	0000001
10X00000000000000001
1000000X0 000 00	001
10000000	000	00	0001
1	0 0	00000 000000 1
1000000000 000X00001
100 0  XN000	00 0	01
11111111111111111111
