NO test_artifacts/valid.xpm
SO test_artifacts/valid.xpm
WE test_artifacts/valid.xpm
EA test_artifacts/valid.xpm
F 71,31,26
C 178,142,38

11111111111111111111
10010001000000000001
10001000000000000001
10001010000000010001
10000001000011011001
10101101010000000001
10100010010100000001
10000100000000000001
10000010010000100001
10000000100000001011
10000000000001000011
10001000000000001101
10000000100001000001
10110000001001000001
10000000100000000N01
10100000000111100001
10000100010000010101
10001000100000001011
10100000001000000001
11111111111111111111
