NO test_artifacts/valid.xpm
SO test_artifacts/valid.xpm
WE test_artifacts/valid.xpm
EA test_artifacts/valid.xpm
F 62,94,188
C 20,64,196

11111111111111111111
10X X000XX0 00 00001
100 000X0000	000X001
10000 X0 	 00 	0X001
1000X0000X0 00000001
1	00000XX000 0000001
1000N00 	0000000 001
100 X0 0 X0	0000 	01
100X0XXXX00000 000 1
1 0000 0000000000001
1 000 0XX0000X0X 001
1000 000 000 X000001
100000X00000000000 1
1	0000X 0	0000000001
10 0000000X0 0000001
1 000	X0000			0 00 1
100X X00000000	 	001
1000000000 000000 01
1	000X0 		X00 00	 01
11111111111111111111
