NO test_artifacts/valid.xpm
SO test_artifacts/valid.xpm
WE test_artifacts/valid.xpm
EA test_artifacts/valid.xpm
F 76,13,29
C 80,116,119

11111111111111111111
11000010000000000001
11100000100010000001
10000000000100010001
11101100000000000101
10000000000000000001
10000000100010110001
10000000101000010001
10000000000100000001
100000100N0000100001
10000001000000000011
11000100000000000001
10000000100100100001
10000001000000010001
11000010000000000001
10100000010000010001
10100000001010010001
10000000100110100001
11010100000000000001
11111111111111111111
