NO test_artifacts/valid.xpm
SO test_artifacts/valid.xpm
WE test_artifacts/valid.xpm
EA test_artifacts/valid.xpm
F 100,104,222
C 238,45,225

11111111111111111111
10010000000100000101
11000100000100000001
10000000000001000101
10010000000000100011
10001000100000000011
10001001000000001001
10000010000000100001
10000000000001000001
11000001000000001001
10000010100001100001
11010110011000100101
11000001000000001011
11100000010010100001
10010010100011000001
10001011000001010001
10100010000000000001
1001000000N001000001
10001001000000000001
11111111111111111111
