NO test_artifacts/valid.xpm
SO test_artifacts/valid.xpm
WE test_artifacts/valid.xpm
EA test_artifacts/valid.xpm
F 65,235,31
C 203,205,22

11111111111111111111
10 00000000000	00001
10000 0000000 0000X1
10000X000 0000000	01
1000 00	  00X0000001
1  00000 00000	0	001
100 00000000X0000001
10	0 0000 0 0	000 01
1000	 000000X 0000X1
10	X000X00XX00000 01
10	00X0	0000000000	1
100 0000 0000	X00X	1
10000X000000X000 001
10X00000000X 000	 01
10X00000X0X0000XX001
1000000000X0X0 00001
10 00000X0X 0	X00001
1X	00XX00 000	N00X01
10000000000000000X01
11111111111111111111
