NO test_artifacts/valid.xpm
SO test_artifacts/valid.xpm
WE test_artifacts/valid.xpm
EA test_artifacts/valid.xpm
F 141,2,183
C 112,250,3

11111111111111111111
11000000100001010001
10000001100001000011
10100100000101000001
10001001000010000001
10000001010000100001
10001000011000000101
10101010000100000001
10001000110000010101
11000000000000000101
11000100000001010111
10000100010001001011
10000100000000100101
10100000010100000101
10001100000001000011
1100000000N000000101
10100000000000100101
10001010000000000001
10000000100001000001
11111111111111111111
