NO test_artifacts/valid.xpm
SO test_artifacts/valid.xpm
WE test_artifacts/valid.xpm
EA test_artifacts/valid.xpm
F 218,113,138
C 24,5,244

11111111111111111111
1000000000 00000	001
100		0 00 00	0000001
1 0 X00XX000000 00 1
1 000000000000X	X001
100000	000000X000 01
10000X0000	00 00 001
10 0 0X	00	00000X001
1X0 000X0	00 00X0001
100X0X0 0000000 	001
100 0	X0 00 000X0001
10000000 00000 000 1
1 	00X0	X 0000X00 01
1000000X00000000X001
10000 0000 000 00 01
1000000000000N000001
10	0000 00X0X0000001
1 0	0000000000000001
10X00 00 00X0X000001
11111111111111111111
