NO test_artifacts/valid.xpm
SO test_artifacts/valid.xpm
WE test_artifacts/valid.xpm
EA test_artifacts/valid.xpm
F 153,80,144
C 33,168,120

11111111111111111111
10100000110000000011
11010100000001000001
10000001000000000001
10000100101100001011
10100000001100000001
10001001000000000001
10010100000100100001
10010000000000100001
10101010000000000101
10001000010N00001001
10001001010000000001
10000000001000001011
11000100110000000001
10000100111000001011
10100001000000000011
10000100011000000001
10000000000000000001
10010000100000100101
11111111111111111111
