NO test_artifacts/valid.xpm
SO test_artifacts/valid.xpm
WE test_artifacts/valid.xpm
EA test_artifacts/valid.xpm
F 238,16,229
C 104,49,135

11111111111111111111
100000000X00 0000001
1000X0000	000000XX01
10000	00000NX0	00001
10	00X 0000000 0 X01
100X00000000 00000 1
1000000X0X000 00 001
10000  0000	0000X001
10X 	X0000XX0 00 001
100000000000X0X00001
100 X0000000X0000001
1 X0000X	 0	00XX0X01
100000000X000X0 00X1
1000000000		000 0001
10X00X000000000XX001
10	000 00X0 000 0001
1000000000000	X00001
1000 00000X0 0000 X1
10000000000000000001
11111111111111111111
