NO test_artifacts/valid.xpm
SO test_artifacts/valid.xpm
WE test_artifacts/valid.xpm
EA test_artifacts/valid.xpm
F 70,195,33
C 12,123,121

11111111111111111111
10000X00000000X00 01
1000000000000000  01
1000 0X000X0X0	00	01
100X 000000	0X0X	 01
1000X0X0000000000001
1X X0000X 000000 001
1 0X000X 000 0000  1
1000	0 00X X000X0	X1
1000000000X00000X0X1
100000XX0 000	0 0X 1
1X00000	00X0000 0X01
10000X000000 0000	01
1000000 0 0X0000XX 1
100000X0000000000001
100 	0000XN0X0000001
10000000000X00000001
1000X00 0	 0000000 1
10000000X0X00000 001
11111111111111111111
