NO test_artifacts/valid.xpm
SO test_artifacts/valid.xpm
WE test_artifacts/valid.xpm
EA test_artifacts/valid.xpm
F 124,18,247
C 141,206,230

11111111111111111111
10010001000000100011
10010110000110011101
10010001000100010001
11001100000110000111
10000001000000100011
10100000000010001001
10000000000010000101
10100000000100010001
10100000000000001101
10000010100010000001
10001000000100000001
10010000000000000011
10101000000000000001
10000000000N01100111
10000100000000101001
11100000010010000001
10000010100010000001
10100000001100000101
11111111111111111111
