NO test_artifacts/valid.xpm
SO test_artifacts/valid.xpm
WE test_artifacts/valid.xpm
EA test_artifacts/valid.xpm
F 71,,0,0
C 172,193,194

11111111111111111111
100000000 X0 0XX 001
1 00X0000X000X000001
1X00X0 X00	0 	000001
1	0 000 0 0000000001
100000000000  000	01
100000000 0X0000 001
100	 X000000X0	00001
10	00 00000000	00001
100000NX000X00000001
1000   	000XX	00X0 1
1X0X0 000000 0 00001
10X00 X00000000X 001
1000000 0X00000	0001
100 0X0000000 000001
1X00000 0 000X000001
10000000000000000001
10000X0X0X000000 X01
1000	00000 XX0000001
11111111111111111111
