NO test_artifacts/valid.xpm
SO test_artifacts/valid.xpm
WE test_artifacts/valid.xpm
EA test_artifacts/valid.xpm
F 119,111,126
C 162,222,82

11111111111111111111
1000000000 00000X 01
1 XX0000N	000		 	001
10000000000 	00X0 X1
100000000	 00 00 X01
10	 0000000 00000 X1
1X00 00000X	X 0000X1
1000 0000  00 0X00 1
1 0XX0000	 000000001
1X00000	 00XX000 X01
1	 00	00000000X00	 1
10 0000X0X0		0000001
100 0 0000 0X0000001
1X00X000000000X00	01
100000 000 000000X01
1X00	00	0 0	 0 00001
1	000000X0 00	000001
100 00 XX0000X0X0001
1000000	X0X0X 0 	001
11111111111111111111
