NO test_artifacts/valid.xpm
SO test_artifacts/valid.xpm
WE test_artifacts/valid.xpm
EA test_artifacts/valid.xpm
F 156,166,174
C 72,104,219

11111111111111111111
1X0000000X0000000001
1000X00 0X00 0000001
100	0X0X0X 0000X0001
100X00XX0X0XX0X0		X1
100000000000 0000001
10X000X00000XX0	0001
1	 000	00000 00000X1
1	XX0000000000	0X001
10 0X00 00 00000X001
1X00000	000X000X0 01
1000 000000 0000 	01
1 000	00X000 00000 1
1000 000000000000001
1 0X0 	0000X00000001
1 00	0000 000 000001
1000	0000N0000X00001
1X0000 0 00000000X01
10X00X000	XX00 00 X1
11111111111111111111
