NO test_artifacts/valid.xpm
SO test_artifacts/valid.xpm
WE test_artifacts/valid.xpm
EA test_artifacts/valid.xpm
F 9,11,120
C 116,161,196

11111111111111111111
1X00 000XX000000 001
1X0000XX00 0000 0001
10000000X	 00000 001
1X0000X0000000	X0001
1000X X000	000000001
100 00000	000X0X 001
100X 00000 000000001
10X000000	0000000X01
100 000000X0000000X1
1X00000 	00000	00001
1 0	0000000000000X01
1	000 0	0	00000 00N1
1	0000 X00000X000001
1000X00 0X X00X 0001
10	00 X0	0XXX0000 X1
10X00X 0000 00	00001
100000000000X0000001
10 0	00000 000X00001
11111111111111111111
