NO test_artifacts/valid.xpm
SO test_artifacts/valid.xpm
WE test_artifacts/valid.xpm
EA test_artifacts/valid.xpm
F 51,,0,0
C 126,142,161

11111111111111111111
1	00 0X 0000	000X001
10000000000X00000001
10000X0 0 	0 X0X0001
1 X00000X000X0000001
100XX	00000 0000 001
100  0X0	00X	0 000	1
1	00	0 X000 0	0000X1
100000X0000 000X0N 1
100X00	X000000000X01
1 0 0000000000 00001
10000000000  0000001
10X00000 0000000X0 1
1X0 00000 XX00X0 0X1
10000		0X0 0		000001
10000X00X00	000 00X1
10X0	00000X000 00001
1	000000X0000000X 01
100000	0000 000  001
11111111111111111111
