NO test_artifacts/valid.xpm
SO test_artifacts/valid.xpm
WE test_artifacts/valid.xpm
EA test_artifacts/valid.xpm
F 252,146,218
C 182,241,195

11111111111111111111
10000000X0 0X0000001
10 000000	0000000XX1
10 	00  0X000X000001
10X00 0X0X000  00001
1000 00 		 00000	001
10000XX0000 0	000 X1
1000X0000000000X0X01
10X0000X	000000000	1
10 00000 000	0000001
1X0	0X00000000000001
100X0000N00000	00001
10X0000000	000 000X1
10X00X0000	 X0 00001
1 00X X00X 00 000001
10	00X	000X000000001
1000000000	000000001
100000 000X0000  001
100X0000	0 000000001
11111111111111111111
