NO test_artifacts/valid.xpm
SO test_artifacts/valid.xpm
WE test_artifacts/valid.xpm
EA test_artifacts/valid.xpm
F 225,124,204
C 155,102,183

11111111111111111111
100000X000000 X00001
100X0 0X0000X00X0 01
1000000X000000	0X001
1X0000	0X0	00X X0001
1X 0 0  00X000	000 1
1 X0000 0000000 X	X1
1 0	00 0X0X000 0XXX1
10000N0000	X00000001
1 000000000X00000 X1
1 0 0	00000X00000	 1
1 0	000000 000000001
1X0  000000000 00001
100 0X00X0000X000 01
100000000 0000	 0001
10X0		000X0X00000 01
1 00X00X0000X00000 1
10000000 0  0 0	X001
10 00000X00000000001
11111111111111111111
