NO test_artifacts/valid.xpm
SO test_artifacts/valid.xpm
WE test_artifacts/valid.xpm
EA test_artifacts/valid.xpm
F 188,38,127
C 246,56,161

11111111111111111111
1X 000000	00X 	X0001
1000X00000000 000 01
1000 X00  0000000X	1
1 000000	00 0 0000X1
1 00	0000000000	0 01
1 000	0 0 000X000001
1X0000000X0000000	01
1X0 0X0000 000000 X1
1 000000000000	0 001
100000000	00 00000	1
10	0000	000	00X00001
1  X0X00 00000 X 	01
100000	00000 0X000X1
1	0X0000 00000000001
10N000X0000XXX 00	01
10000	00X0X0X00X00 1
1000000	  0000 0X001
100 00 000 0000000 1
11111111111111111111
