NO test_artifacts/valid.xpm
SO test_artifacts/valid.xpm
WE test_artifacts/valid.xpm
EA test_artifacts/valid.xpm
F 188,236,130
C 62,148,23

11111111111111111111
10000000100000100001
10101000100001001101
11101100000101000001
11010000000001110001
10100000001000000001
11000010010000011001
10100000000010010001
10000011010000001001
10010010000100010001
10000000010100100001
11001100000010100001
10001000000010000101
10011001001001001011
11001000100010000001
10000100010000000001
10100100000000000001
1000011000010N010001
10000100001100001011
11111111111111111111
