NO test_artifacts/valid.xpm
SO test_artifacts/valid.xpm
WE test_artifacts/valid.xpm
EA test_artifacts/valid.xpm
F 127,,0,0
C 167,147,122

11111111111111111111
10 00000X00X00000001
10	00000000000XX 001
1 000		0000XX0 00 01
1	0000	X00000 X 0001
10000 00000XN0X0 001
100X0 0000X00 000001
1000 000000	0X	000X1
10000000	0000	000X01
1 0X	000X0 0X0	X0001
10000X0000000000	001
10	0 0	0X0000	000001
10X000 00000000000	1
1000000	0X000000 XX1
10000000 000	000X 01
100000X	0 0 0000  X1
1000  00X00	00000001
1	0000000 0000000  1
100	0000	X000 000001
11111111111111111111
