NO test_artifacts/valid.xpm
SO test_artifacts/valid.xpm
WE test_artifacts/valid.xpm
EA test_artifacts/valid.xpm
F 225,114,168
C 230,153,222

11111111111111111111
11000000010001000011
10000000000011000011
10000100000100000001
10000000000010001001
10101000101101010001
10100000101011011001
10000100000000000001
10000010000110011011
11001001001000001001
11100000100000000001
10100101000100110011
10000010000000000101
10000000000000000001
10000000011000100001
10000N00110010000001
10000000110000000111
10000001000000010011
10001001000000100011
11111111111111111111
