NO test_artifacts/valid.xpm
SO test_artifacts/valid.xpm
WE test_artifacts/valid.xpm
EA test_artifacts/valid.xpm
F 29,9,89
C 108,20,208

11111111111111111111
10101000001010100011
11000000100000010001
10100000010000010101
10100000000000000101
11001011100100100001
10000001000000010001
10000000010010101101
10000100100010000001
10000000000100001001
10000000101000000001
10100010101010100001
10101000100011100101
10000100001100010001
10000000010000010101
10000100000000000001
10010001100000101011
1001001000N010000001
10000100000000010001
11111111111111111111
