NO test_artifacts/valid.xpm
SO test_artifacts/valid.xpm
WE test_artifacts/valid.xpm
EA test_artifacts/valid.xpm
F 189,54,173
C 103,179,153

11111111111111111111
10001010100000000001
10000010000001000001
10000101101010001111
11000000001010101001
10100010000100010011
11010000000000000001
100101000000000N0001
11000100000110000001
10001110100001000001
10100000000010000001
10000100000000101011
10000100000000010111
10101011000001101001
11000010001101000011
11000000010010001101
10001000000000000001
11010000101000000011
11011000000000100011
11111111111111111111
