NO test_artifacts/valid.xpm
SO test_artifacts/valid.xpm
WE test_artifacts/valid.xpm
EA test_artifacts/valid.xpm
F 231,95,36
C 210,138,252

11111111111111111111
10X00000X	0000000 01
1X0	000 00000000X001
1 	00000	0 X00000001
100000X0 00000X0 0X1
1X0X0000 0	0	00XX0 1
1000000X000X0	000001
100XX0X00000000000X1
1 00000000000X0000X1
100X0X00X0X0 0X 0NX1
10 0X00000X00000 001
10 0	000	00 0X 00001
10 00000	0X 0 0 0X01
100000000	000000X001
10000000000000000001
100000000X0X0X00 001
1000000000X000X0	0X1
1000 X	 0000X000 001
1X000X00X00X 0X	00X1
11111111111111111111
