NO test_artifacts/valid.xpm
SO test_artifacts/valid.xpm
WE test_artifacts/valid.xpm
EA test_artifacts/valid.xpm
F 39,0,0
C 28,120,237

11111111111111111111
100	X 000 00000X0001
1 00000000	0000 0001
1 000000X00	 0X00001
100 0000X X000000001
100000000 0X0	00 0	1
100000 000 000 00001
100000000XX000X00001
10000	0X000X 	0000X1
1 X0X	 000	0X000X001
100000000 00	0000001
100000X	0000X00X0001
100	0 0X 0X00000X001
1000X00000 00X000 01
1X0000000X0X0  N0001
10 0	0000 	000000001
1 0	0000000 0 000001
1X 0000X000 0X000001
10XX00000 000X	 0001
11111111111111111111
