NO test_artifacts/valid.xpm
SO test_artifacts/valid.xpm
WE test_artifacts/valid.xpm
EA test_artifacts/valid.xpm
F 36,126,191
C 20,216,226

11111111111111111111
1000	00X0000000X0001
100000X 000000000001
1	000 000X0X00  0001
1000 00 000000X00001
1000X0	00000 00 0001
1X000000X 000000X001
10000	00000000000X 1
100X0X0 00XX0X0 0XX1
1 0X0000X00000X00 01
1000000000X000000X01
10000000000	00000001
10 0000000 0	0X00 01
10X0X 0000 0X0 0 001
10 00X0 0XX00000	 01
100 	N00X   0000X 01
100 X00 00 0000000	1
100000	0000 000	0001
10X0000 000	00X00X01
11111111111111111111
