NO test_artifacts/valid.xpm
SO test_artifacts/valid.xpm
WE test_artifacts/valid.xpm
EA test_artifacts/valid.xpm
F 296,0,0
C 226,149,126

11111111111111111111
1	00000 000000000001
10	00 000X00	0XX0001
1000000X 00000 X0001
10X 000000X00	000001
10000X0	X00000000001
1X00	X0	0X00	00 0N01
10000000000000000	X1
100000000000	00X0X01
1000	 0X000000 0 0X1
10X00 0 00X00 0000 1
100 		 000X0X0000001
1000000000X0X0X00001
10X0000	0000X00X0001
100X00 000X0000000 1
10X00000 00X000 0X01
1	00000000 0000 0001
100X0X00000000 00X01
1 0 X000000 0000 0 1
11111111111111111111
