NO test_artifacts/valid.xpm
SO test_artifacts/valid.xpm
WE test_artifacts/valid.xpm
EA test_artifacts/valid.xpm
F 193,115,102
C 61,162,156

11111111111111111111
10000010010000001101
11100000000000000001
10010001000100001011
10001100000010000011
10000110110001000101
10010000000000001011
10100000000001000011
10010001010100000001
100100000000000N0001
11101000100000000101
10000000010010011001
10001000001000100001
10100100000000110001
10000000010000011001
10000000101000010001
10000001110101100001
11110000000010000001
11000101000100000001
11111111111111111111
