NO test_artifacts/valid.xpm
SO test_artifacts/valid.xpm
WE test_artifacts/valid.xpm
EA test_artifacts/valid.xpm
F 120,156,136
C 63,104,149

11111111111111111111
1	000000XX0000000001
10000000X000X0X0	001
1000 0X00X00 0000X01
10X0	0000N0X00 	0001
1 0X00 00000000	0X01
1000 X000 0X0000 001
10	000000	X	000000X1
1X0000000 X  00X0001
10000000000 	0 0	001
100X0 000000X0000001
10 X0000 X 000 00001
10X0000000000 0000X1
10000 X000000		00001
1000 0	0000 000 X001
100000000  0X0 X0001
1 X0 00	000000X0 001
10  X00000000		X 0X1
1000000000000X000001
11111111111111111111
