NO test_artifacts/valid.xpm
SO test_artifacts/valid.xpm
WE test_artifacts/valid.xpm
EA test_artifacts/valid.xpm
F 20,,0,0
C 177,249,19

11111111111111111111
1X00X0 000X0X 00	001
10X0000 000000	  001
1 0X0X0000000000X0X1
10	00 00000X00	0	001
1XX00	 00000X0000001
1 0 00 00 000000X001
1	00000X000000000N01
1 000X000000 X000001
100	000	00000000 001
1 0X0000X0	0	0000	01
1 0000 0000X 0000001
100000 0000 	0000001
1000X0	0000000 00001
1 0  0000	0 0 000001
10  00X	0000  000X01
10X0  000 00000  	01
1 000000X0	0	000X001
1 X0  000X0000000001
11111111111111111111
