NO test_artifacts/valid.xpm
SO test_artifacts/valid.xpm
WE test_artifacts/valid.xpm
EA test_artifacts/valid.xpm
F 239,126,239
C 9,255,224

11111111111111111111
1000X0X00000000000	1
1000000X00000X000001
100000000XX 000000	1
10 00X00X0000000X0	1
10000	00X0	0000 00 1
10000 000XXX00000001
100 000000 00X 00001
100 0	000	0000N0X0 1
10000 00000 000000 1
1000 000 0	0000	0X01
10	0000X  X000000001
10000 000000 000	001
10000 0000000000X001
10000X00 00000X0 	01
100000X0 000X00 0X01
10 00000000 00000001
1 000000	000X0 00001
10000	000XX0 000X001
11111111111111111111
