NO test_artifacts/valid.xpm
SO test_artifacts/valid.xpm
WE test_artifacts/valid.xpm
EA test_artifacts/valid.xpm
F 117,144,237
C 248,160,185

11111111111111111111
10X0 000 	0000000001
100X0 00000000X 00X1
10	0000X000000 00 	1
100000XXX0000	X 0001
10000X0	000000000001
10 000000	X0	0000 01
10000 	0000000000001
100000000000000X0		1
1000X000000000X000 1
1000000 000 0 000001
100X00	X000000000 01
100000000000000 X 01
10X 0 0 0000N00 00	1
10000X00000 0 XX00X1
1	0000	0000000	 0	01
10 0X0 0000000 00001
1 0X000000	000 0X0X1
1000X0X0000000000001
11111111111111111111
