NO test_artifacts/valid.xpm
SO test_artifacts/valid.xpm
WE test_artifacts/valid.xpm
EA test_artifacts/valid.xpm
F 0,142,131
C 207,207,46

11111111111111111111
100000X000000 000001
1X 00000X000X 0	 0 1
1000 0000000 000X0	1
1000	0000000	0X 0001
1 0X00000X0000000X01
10000000 000X0 00	 1
100000X000X0		0	0001
1 0000XX00 X00000001
1X0 00000	00X0000001
1X 0000 0X 000000001
100N0X00000X0  XX0X1
10 00	X00 00X0 00001
100	00 	000X00000001
1000X0000X0000X00001
1000000X 000  000001
1000 000000 00000 01
100000 00	000	0	0001
1000000	00 0X000X0X1
11111111111111111111
