NO test_artifacts/valid.xpm
SO test_artifacts/valid.xpm
WE test_artifacts/valid.xpm
EA test_artifacts/valid.xpm
F 245,77,115
C 143,20,23

11111111111111111111
1 000000 0000X00	001
1000X000	0 X0N000	01
1 0	0X00 0 0	0 X0001
10X0000000 X	000	0 1
1000 X000000X00	0 01
1X000000 00 0	000XX1
10000	0	00 00X000X01
100X0000X0000 0 X001
1X0 X00 00X0000X0001
10	000 0	0	0000 0001
1	0X0X000000000X0 01
10000 0000000000 001
100000000000 0X00	01
10000000 0000	00X001
1XX00000000X000 0001
100	0X	0X	0000	0X0 1
10000 0 X 0 0X000X01
10X 00 0	00000X00001
11111111111111111111
