NO test_artifacts/valid.xpm
SO test_artifacts/valid.xpm
WE test_artifacts/valid.xpm
EA test_artifacts/valid.xpm
F 76,,0,0
C 26,209,88

11111111111111111111
1X000000000000X00001
1X00N000000000000001
100000000X00000XX0X1
10  00000000000  001
10X 00	0X0	X00X0 001
100X0X00000000000001
10000000000	 000X001
10 000 0000X00000001
10X0 X00	00X00  0001
10 00X000 0000000X	1
1 00X00X	00000000X01
1 000000	X0X00 X0 01
10000 0	00 0X0000001
1000 000	00000	0 001
1 0000	0  0000000001
10000000	00 00X000	1
10000	000000X00000X1
10X0X000X00X0	  0001
11111111111111111111
