NO test_artifacts/valid.xpm
SO test_artifacts/valid.xpm
WE test_artifacts/valid.xpm
EA test_artifacts/valid.xpm
F 142,200,207
C 251,243,251

11111111111111111111
1X000X0000  X0000001
100 00  0	000X0 X0 1
10N00	000 00X00000X1
10000000X00000000001
100000 00X0		 0000	1
1X0000000	000X00 0X1
1X00 0X00XX0XX000X01
1000X0	 000XX00	0001
10000X0000X00X 00 01
1000000 0000	0000001
100X X0 0X000000 0X1
10000 000X000000X001
100 0000000000000001
100000X00000 0000001
1X00 0000000X000 001
1000 0000 0000000001
1000	0	00 XX00X00001
10X00X00 000000X00	1
11111111111111111111
