NO test_artifacts/valid.xpm
SO test_artifacts/valid.xpm
WE test_artifacts/valid.xpm
EA test_artifacts/valid.xpm
F 91,0,0
C 235,50,159

11111111111111111111
1 	0 00000000000X0X1
1 000000XX 000000X01
10	0 00 000X 0 00	01
100X0X00X00 0	 00 01
1000X00X0000 0000001
1 	000X X00X000000	1
1000000XX 0000000001
10XX00X0000	000X0X01
1 00000000  00	00001
10000 0 00 0X 	XX0 1
10000000000 00000 01
1X	000	00X00000X0001
10	0000000	000000001
1000X000	0 00 0 0	01
100	00X0000X00	N0001
100X0000000000000001
1000XX000 00XX0000X1
10 00X00	00 X000 001
11111111111111111111
