NO test_artifacts/valid.xpm
SO test_artifacts/valid.xpm
WE test_artifacts/valid.xpm
EA test_artifacts/valid.xpm
F 102,79,135
C 62,42,104

11111111111111111111
10000000000000000011
10100000010000011101
10000000000000000001
10010001010000000101
10010000000100000001
10000100100100000011
11101010000000011001
10000101000000100001
10000010001000001001
10000001000000010001
10001000000100000001
10000010100100000011
1010001010010N000001
10000011000000000001
10011110010100010001
10000000000000010011
10010000000000000001
10001000100000000111
11111111111111111111
