NO test_artifacts/valid.xpm
SO test_artifacts/valid.xpm
WE test_artifacts/valid.xpm
EA test_artifacts/valid.xpm
F 115,86,85
C 139,52,68

11111111111111111111
100000000000000000 1
1 00X0	000 X0 	0X0	1
100000000000X0000001
10000000	 	0000X0X01
100000  00 0X 0000 1
1000X0000XX00 000 01
1 000	0	X000000 0X01
1000000  0X000 00001
10000XX000000XX0X 01
1 00	0000  000000001
10 	 000 	000N00 0X1
100000 X0X0000	00001
1000 00000 000000001
10 0000 000000000001
100000000 XX00000001
10 000000		 X00X00X1
100000X0	00X00000X01
10X	0000 00	00 000 1
11111111111111111111
