NO test_artifacts/valid.xpm
SO test_artifacts/valid.xpm
WE test_artifacts/valid.xpm
EA test_artifacts/valid.xpm
F 14,224,231
C 224,52,193

11111111111111111111
10000001000000001001
10000100111100000001
10000000100010100001
10110010000111100101
10000010000000000001
11000000010000000001
10000000100000100001
10010100001000000101
10000000110011001001
11000001100001000001
10000N00000000000101
10000000000000000011
11010000000000100011
10000010001010000001
10100000100001000011
10000100001000010101
10000010000000000011
10001000000000011101
11111111111111111111
