NO test_artifacts/valid.xpm
SO test_artifacts/valid.xpm
WE test_artifacts/valid.xpm
EA test_artifacts/valid.xpm
F 78,,0,0
C 209,48,210

11111111111111111111
100	0 000000000000 1
1000 000 0	 0X0X0001
1X  000 	0X00 00X001
1000000 00 00X0 0001
1000	 000000	00000X1
100 0	00  00 00000 1
1 XN0  000X00X0 	 01
1000000X000000X00001
1X0	0000000000	00001
1X00000000	00X000001
1	00X00X000000000001
10000X000000000X0001
10000X 0	0000X	00 	1
1000	X000	0000000	01
1 00000000X00	000 X1
100000000000000	0 01
1000000000X000 00001
10000	0000	000000001
11111111111111111111
