NO test_artifacts/valid.xpm
SO test_artifacts/valid.xpm
WE test_artifacts/valid.xpm
EA test_artifacts/valid.xpm
F 199,113,143
C 189,56,47

11111111111111111111
100X0 XX00000000X001
1 0000 00000X0000001
1X0XX0000000 0000001
1	00000000	000X 00X1
1000	00000000000	  1
100 00 0X000 00000	1
100 0 000000000XX0 1
10X00	00000 0X 0 0 1
10000000000000000001
1 000000X 000000	001
1	0000X00 0 00000001
1000X 00N0000X 00001
10000 00000	X0000001
10	0X 00000000X00001
1000X00000000 000001
10 00 000  0X00X0001
10000XXXX0	  000  01
10000 0000X0000	00 1
11111111111111111111
