NO test_artifacts/valid.xpm
SO test_artifacts/valid.xpm
WE test_artifacts/valid.xpm
EA test_artifacts/valid.xpm
F 136,,0,0
C 55,74,14

11111111111111111111
100000X 000	00	000N1
1 00X0X0 00000000	01
1X0 00 0	00000X0  01
1000 00	0	000000	001
10000000000000	0 001
1 0 00 0 00XX00000X1
1000 0 00 X0	0 0 001
1000000000000X X0001
1000 	X00   0000X001
1 000000 00000X0X 01
10000X00000	 0 00001
10X000	0 000X000 001
10000000X00 X00	0001
1	00000000X0	0000		1
100 0X 000 000X00001
100 00X0 00000000 01
1000000000000  00001
1X00   00	00 		0	001
11111111111111111111
