NO test_artifacts/valid.xpm
SO test_artifacts/valid.xpm
WE test_artifacts/valid.xpm
EA test_artifacts/valid.xpm
F 148,,0,0
C 142,253,131

11111111111111111111
100	0	00 000000 0001
100000000X0000 00001
100 X000 0000000X001
1000 00000	000  	 01
100 0 000	0000000001
1 00 X 0000000000001
10X0 000000000	00001
10  0000000 0X000001
10 000000   00000001
1000X00 000X00000001
1X000  0  00	X000001
10NX 	000000X0000001
1	00	000 X0 000X0001
100000 0000000X00001
1000000X	00000000001
100XX	000000		000X01
1X000 0000X00X000001
100 X00	0000000 0001
11111111111111111111
