NO test_artifacts/valid.xpm
SO test_artifacts/valid.xpm
WE test_artifacts/valid.xpm
EA test_artifacts/valid.xpm
F 57,,0,0
C 150,98,138

11111111111111111111
1	X0000000X000	0X0X1
1 X00000000	00000001
1000 0X0	0000X000001
10 000	00000000 0001
10 0X0 00X00000X	0X1
1000000000  00 00001
1000000X	00 00000001
10 00 00000000XX0001
10 000N000X000X00001
100000	000000 000001
10   00000		000   X1
1X0 000 000X00000X01
100X0X000 	0000X0001
1000 0X0X000000 0001
100000X 0X0   0000	1
100000000000000X0001
10	00000 0	00 X0	001
1 00000 0X0000000XX1
11111111111111111111
