NO test_artifacts/valid.xpm
SO test_artifacts/valid.xpm
WE test_artifacts/valid.xpm
EA test_artifacts/valid.xpm
F 152,8,120
C 178,200,111

11111111111111111111
10000	00000000000X01
1000X00			0 00000001
10000X0X0	X000000 X1
100	0000 00X00	0	 01
1000X00X000	000000 1
1X		000X  X0 X0X00X1
10000XX0 0 0000X00X1
1X 0000X0X  0 0X0001
100X0XXX 0X	00 X0001
1	 0 00000N00 0  	01
1X0	 0000000 00 0001
10000X0 X000000	0	X1
1000XXX0000X000X0001
10 0000X00	 00000001
1 0	00000	00000	0X01
1 0 0 0000XX0000 001
10000	0000XX000 0X01
10000 00000 00X00001
11111111111111111111
