NO test_artifacts/valid.xpm
SO test_artifacts/valid.xpm
WE test_artifacts/valid.xpm
EA test_artifacts/valid.xpm
F 145,,0,0
C 145,117,111

11111111111111111111
100  0000000X00 0001
10XX000XX00X00000001
1X00000X00 000   001
1000000X0000000 0001
1000000XX00000000001
10X 000000X0 00 0  1
1X00000X000000000001
1N XX 00 XX000 0 001
10 X00 0000000X0X001
1X	 0000000	X 00 X01
100XX	000000X00X0001
1000000 X000 00000X1
1 0000 00000000XX001
10000	000X00X0000001
10000X0 000 000X0X01
100	X000000000X 00X1
1X0X0 0000X000000001
100000000X000000X0X1
11111111111111111111
