NO test_artifacts/valid.xpm
SO test_artifacts/valid.xpm
WE test_artifacts/valid.xpm
EA test_artifacts/valid.xpm
F 184,184,71
C 178,213,31

11111111111111111111
10010001000000010111
11100010010000001101
10000000000001000001
10000000010000000001
11000000000101000001
10000100000000000001
10000001000000001101
111000100N0000001001
11110010000000001001
10100000000110000101
10001010010001001001
10000000000000000101
10001000100000001001
11010011000000110001
10000100001100100001
10100000001100000001
10110010000000000001
10000100000000000001
11111111111111111111
