NO test_artifacts/valid.xpm
SO test_artifacts/valid.xpm
WE test_artifacts/valid.xpm
EA test_artifacts/valid.xpm
F 200,50,170
C 76,241,95

11111111111111111111
10X 00X00000X0000X01
1000000X00	00000X	01
10	0XX	0 XX0	0000001
1 00X0000000X000 001
1000 00000 00	000001
1000000 00X000000 01
10000 	00000	0X0 	 1
10 0XX  0 0000000X01
1 000000000000 00001
1000000 0000  000001
10 00000000	0000X001
1000X0X00 00 000	0 1
10	0 000000 0000 X01
10	000000 0N00 00001
10000  0000X0X0000X1
1XX000 00X0 0	000	01
100XX000000000000001
10000	0000	00 000001
11111111111111111111
