NO test_artifacts/valid.xpm
SO test_artifacts/valid.xpm
WE test_artifacts/valid.xpm
EA test_artifacts/valid.xpm
F 228,16,60
C 95,68,244

11111111111111111111
1000	0X00000	0X00 X1
100000X000000000		01
100 00 00  000 000 1
1000X0 0 00000000001
10000 000X000	 	0001
100000000N0000000001
10	 0X0X00   0000001
1000X0000	0000000 01
1X0	000000000X	00001
10000	00000 0X	00	01
100 X000000000 00 01
100 000 0000  00 0 1
100000000X 0  0X0001
100XX00 0X0000000001
100	X	00 X 000X00001
1	00000000X0000	0001
100 X0000X00 00X  01
10	00X00 00	00 000X1
11111111111111111111
