NO test_artifacts/valid.xpm
SO test_artifacts/valid.xpm
WE test_artifacts/valid.xpm
EA test_artifacts/valid.xpm
F 85,203,113
C 40,175,79

11111111111111111111
10000001010000011001
10010100010101011001
10010100011101010101
11000000000100000101
10110000100001000101
10000000100000000001
11000100000100010111
1000000N000000001001
10000000000000010101
10000100010000000001
11000000100100010001
10000100000010010001
10010000000000000001
10010100001000000001
10100100000000000001
11110010000000010011
10010000001000000101
10010010000001000001
11111111111111111111
