NO test_artifacts/valid.xpm
SO test_artifacts/valid.xpm
WE test_artifacts/valid.xpm
EA test_artifacts/valid.xpm
F 170,,0,0
C 220,80,233

11111111111111111111
10 00000 0000	000001
100000000000000	0001
1X 0 0000X0 0X000 01
10	000 X 0 X00000 01
10000X000000X0 00001
1000000000X X0000 	1
100X0 000 000X0X0001
100 0X X0000 0000001
1X00000000	000000001
1X000 0000X000N00001
10X000000X0X000000X1
1000	000  0X 00X0001
1000 	00X00000 0	X01
1X0 00	X	0XX00000001
100 0	000000X0 00001
10 00000X0X0000000X1
100X0	0000	XX  00001
1	000 0 00 0	0000001
11111111111111111111
