NO test_artifacts/valid.xpm
SO test_artifacts/valid.xpm
WE test_artifacts/valid.xpm
EA test_artifacts/valid.xpm
F 39,190,251
C 7,217,181

11111111111111111111
100000000X0X00000	01
10X00000 000	0X00001
10X0000 0 0000 0 001
1 X00000X 0000X000	1
100 00  000 0X0000X1
10	00	00 0 	0000X001
1X0	 0X000	00 000001
10X 000000X000XX0001
10 0	000 000000000X1
100	X0	0000000000001
10000000X 0000X00  1
1  00000 0000X00X0X1
1 00000X0 	X00000001
10000N00X0000 	00 01
100000	0 0 0 	 00 	1
100000	00000000000 1
1000 0000  	X0 0 0 1
1	00000000 000000001
11111111111111111111
