NO test_artifacts/valid.xpm
SO test_artifacts/valid.xpm
WE test_artifacts/valid.xpm
EA test_artifacts/valid.xpm
F 105,231,242
C 45,202,56

11111111111111111111
100X00000X0X0 0000	1
10000000 X0X00	000 1
10X 0X0 X000000 0001
1X0X0 000000000	0  1
10X00000	00 00 0X0 1
100000 0X000	0	00	01
10 0000 0	00 X 	 001
10000X0000  X0000001
1000X 0X0000000000	1
10X  00000000	000001
100000	000000000	001
1X0X0000 		00  0 001
1 00X000 00000000001
1000X0000000XX0X 001
100X0	00	00X	0000	01
10	0X000X00000X00	01
100X0 00000	X	000 01
10000N0X00000XX00001
11111111111111111111
