NO test_artifacts/valid.xpm
SO test_artifacts/valid.xpm
WE test_artifacts/valid.xpm
EA test_artifacts/valid.xpm
F 188,202,114
C 51,80,217

11111111111111111111
100X0X0000000000	0X1
10000000  00X0000	01
1	0X00000X00XX000X01
1000000000000X0XX001
100X00000XX 0	00X  1
1000X 000 X		X0 X0X1
10 XX00			00000 0001
10X0000000X000000X01
10000X0 X0 	00000001
1 000000000000000001
10X0000000000 0	00X1
10 000X0000000X00001
1X0000000NX00 000001
100000	0000000000001
100   000000000 0001
10000000 000 00 	001
1000 00X000	000000 1
100	 00X0	00X0000001
11111111111111111111
