NO test_artifacts/valid.xpm
SO test_artifacts/valid.xpm
WE test_artifacts/valid.xpm
EA test_artifacts/valid.xpm
F 64,,0,0
C 168,125,29

11111111111111111111
10X0		0X 00X00X00X	1
1000000000 000X 0001
100   X00000	00 0001
100000	00X0000000X01
1000000X0	00 0000001
1000000 0	00000X0001
1  0XX0000000N000001
1000  00 0 0 000 001
1000 	00000000000	01
100000	00000	0000001
1000 0000X 000000001
100 0000000000000001
100000000000X0000	 1
100 000X0000 0000001
10X00X0000  000 X 01
1XXX0000X0 0	00 	001
1 0000 000X00XX00001
10000000 00X 00X0001
11111111111111111111
