NO test_artifacts/valid.xpm
SO test_artifacts/valid.xpm
WE test_artifacts/valid.xpm
EA test_artifacts/valid.xpm
F 104,,0,0
C 24,7,130

11111111111111111111
1000 00000	0000	0001
1X0000 000X00X00 X01
10X0 00000	0X00	0X01
1N X000000000X0X0001
1 000X00	00000X00001
100 00000000X0000001
1000 00 000 0000X001
100000	 X0X000X0	001
1XX0000000000000	001
10000000000000 00001
10000 0000	00 000001
1000000000000	0 0001
10 00000 0000 000001
1X0X000000X	00 0	X01
100 00 00X0000000X01
10  00 0000000XX0001
1  0  X	0000 X000 01
1000000X000 0000X0 1
11111111111111111111
