NO test_artifacts/valid.xpm
SO test_artifacts/valid.xpm
WE test_artifacts/valid.xpm
EA test_artifacts/valid.xpm
F 158,251,55
C 182,99,9

11111111111111111111
10X00000X000 0X000 1
1000 0000000	0 000X1
1 0 00000000	XX0	001
1	0 00X0 00  0X0 X01
10000X00  0000000X01
100	0000 00 0000	001
1	00X 00XX0000X00001
10 0000X00000X000001
1000000X000000000001
10000X 000 000000001
10X00000X000000 0001
1000 0X0000 00000X01
100000	000 000000001
10000N000X0000000001
10000000X000 0000X01
100 X000000	0X00X001
100 0000000 0 00 X01
100	X0 00	0000000001
11111111111111111111
