NO test_artifacts/valid.xpm
SO test_artifacts/valid.xpm
WE test_artifacts/valid.xpm
EA test_artifacts/valid.xpm
F 122,0,0
C 248,18,75

11111111111111111111
1X0000000	0000N0	001
1000000 0X0 	00000	1
10000000 00	00000001
10X00000X	0   00 X01
10000000 00000000001
100X 0000000000000	1
10000000 X0X	 0XX0 1
1 0000XX000000	0	0 1
10000000000X000000 1
1X0000	0 0X000000001
1	000000X0	0  00X001
100000X000000 000001
100X0X0000  X00000X1
1000000X000	 00X 001
10X0000X00000X 00001
10X0 	 X0000000X00X1
10 0 00000000X0 0001
100  00 0000X0000 01
11111111111111111111
