NO test_artifacts/valid.xpm
SO test_artifacts/valid.xpm
WE test_artifacts/valid.xpm
EA test_artifacts/valid.xpm
F 186,203,97
C 220,153,84

11111111111111111111
10000100100000000001
10000110000010100001
10100100010000000001
10100011000N00100001
10000000000000000011
10111100000000100001
10000000000001000001
11010000000100000101
10001000100000011001
10001000110000000011
10111101010001000001
10010000100110001101
10101000010010001011
11001010000000100011
10010001100011000001
10000000000100100001
10001000000010010001
10000010101000000011
11111111111111111111
