NO test_artifacts/valid.xpm
SO test_artifacts/valid.xpm
WE test_artifacts/valid.xpm
EA test_artifacts/valid.xpm
F 156,215,50
C 56,68,102

11111111111111111111
10000 0000000000X001
100000 0000	 0000001
100000000X0000000001
10000000000000000001
1000X000X 0	 X000001
10	 X000000000 00001
10000	00X000000X0 01
10X0X0  00000 0 0	01
10000	0000X0000000X1
1000000X0000	000 001
1000000000	0000	0	01
1 0  0000000000	0 01
10000000000 0X000001
10000000X	00000	0001
100	0X 000 00000 001
1 00		00000X0	0 0X01
1X0000000N000000X001
10 0000 00 000000001
11111111111111111111
