NO test_artifacts/valid.xpm
SO test_artifacts/valid.xpm
WE test_artifacts/valid.xpm
EA test_artifacts/valid.xpm
F 276,0,0
C 189,203,132

11111111111111111111
1	X 000X00000X000 	1
100X00  0	0000N00	01
10000X00X0X0000000X1
100X0 0	0X00000 0XX1
1000X000000000000001
1000000000 0 X0X0	01
10		00X0 000 0000001
100X00 000	00X0 X 01
100000X00000X000	0X1
10	000000  0000X00X1
1 000	00000X0XX00001
10000X00X0000000X0 1
100 000000000X0000X1
100000000 0 0000X	X1
1000 X0		00000  00X1
1X0	0000000XX 000001
10 0X0000000000000	1
100  0000000000X0001
11111111111111111111
