NO test_artifacts/valid.xpm
SO test_artifacts/valid.xpm
WE test_artifacts/valid.xpm
EA test_artifacts/valid.xpm
F 176,,0,0
C 189,54,17

11111111111111111111
1X000X0 000 00 00001
10X 0 00 00X000000 1
1000000  0X X0	0	001
10X0 00000000 00 001
1000	00 XX00000X	001
1000000 0X 	000000X1
1	00000X0X00 X0	0001
1X0X 	000 0X0X00X001
1000	000X 0X000X0001
1000X000XX00 0000001
1000X000 00	 X000X01
1000000000000 00	 01
1	00X000X000000000	1
1 0N		X0000000000	01
10000000	00000000001
1000000XX	000000 001
100 00 000000000X001
10   00000 000 00X01
11111111111111111111
