NO test_artifacts/valid.xpm
SO test_artifacts/valid.xpm
WE test_artifacts/valid.xpm
EA test_artifacts/valid.xpm
F 194,248,115
C 21,150,64

11111111111111111111
10000000X 0X 00000 1
100000000X0X0000	001
1000 00 	00000000001
1X00X00000 000000001
10X00	0 00000	00	XX1
100X00X0000X 0XXN001
100	000 000 000000	1
1X0X000X00000X0 0001
1000000 00XX00000001
100000X000 000000 01
1000 00 00000X0000 1
10 	0 000 0 000000 1
10000X00000 0 000001
10000000000000000001
1000 00X00XX00000 X1
1X 00X00X00000X000X1
1000000X000 00X 0001
1000000X000000000001
11111111111111111111
