NO test_artifacts/valid.xpm
SO test_artifacts/valid.xpm
WE test_artifacts/valid.xpm
EA test_artifacts/valid.xpm
F 141,44,89
C 15,146,156

11111111111111111111
10000000011000100101
10000000000000010001
10000000100000000001
11000010001001000011
10000010110100011001
10001010100000010011
10010100000000000001
10001110100100010011
10010010000000001101
10000000110100000001
10000000001010100001
10000010100001100001
10000000011000101011
10110000000000101101
10100010000000100001
10000010000010100001
10000000000000000N01
10100000100100000001
11111111111111111111
