NO test_artifacts/valid.xpm
SO test_artifacts/valid.xpm
WE test_artifacts/valid.xpm
EA test_artifacts/valid.xpm
F 135,196,54
C 103,250,207

11111111111111111111
10X0000X  00 0000X01
1000000000000000 001
10000	00  0X00000001
100 00000 00000000	1
10000X 00000000X0001
10000000000000000001
1000000X00X0 X0	00	1
10000X000X0 000000X1
10 00	0X0X 000000X01
1000X	00000000 X0001
10	00X00XX 00000 001
1 0	0000XN00XX000001
10000000X000	000X001
100X0000000000000 01
100 00000 0000X  0 1
10X00 000000000X 0 1
1	X0X00X  000	000001
1000000000X 00X 0001
11111111111111111111
