NO test_artifacts/valid.xpm
SO test_artifacts/valid.xpm
WE test_artifacts/valid.xpm
EA test_artifacts/valid.xpm
F 250,130,134
C 160,87,89

11111111111111111111
1000	0	0000000000001
1 000X00000000000 01
1000 00X000000000001
1000000000 00 0 0001
10000000000000 0	X01
100	000000X0	00 00	1
1 0X00	00X0000	00X01
100	0X000 00000  001
10000X0 00	00000X0 1
100	X0000000000	00	1
10XN0XX0000  0   X01
10X 000000X00	 00	01
100X0X00000000000001
10	0	000000000000X01
100 000 000000 000	1
1 0 	0	0000X00000001
1 000	0X000X00000001
10X0000 0XX00	00 001
11111111111111111111
