NO test_artifacts/valid.xpm
SO test_artifacts/valid.xpm
WE test_artifacts/valid.xpm
EA test_artifacts/valid.xpm
F 25,18,254
C 246,158,31

11111111111111111111
1X00000 00000000 001
100000000 XX0	000001
10000000 00	0000X001
1000 000000 0	0000X1
1X0000000 0000	00001
1000	00 00000000	001
1X0 00000X00000X0001
100XX00 X00 00 00001
100XX00	0  00X000001
1000000	000 00000 01
1 0 0		000000	0	0 01
100X X 0 000XX	 X 	1
100  00 0X00000X 001
1000000000	000X00001
100X00000000 0000001
10 00000X	0X	0X0	X 1
100000000 00X0000001
100 0X0000000N0X	001
11111111111111111111
