NO test_artifacts/valid.xpm
SO test_artifacts/valid.xpm
WE test_artifacts/valid.xpm
EA test_artifacts/valid.xpm
F 232,,0,0
C 90,158,128

11111111111111111111
1 0 00  0 0000000	01
100XX 0000N000000001
1 00000000	0000 X  1
10 00X00X00000000001
1000 000000XXX000 	1
10	0000000	0	 000001
10 00 00 00  0000X01
10X000X0	0 00XX0	X01
1 X0000000	000X000X1
1X 000000 	000000001
10X0000000000X  00X1
1 0X0000000X000 X0X1
1	000000000000000 01
10000000000XX0 00 01
1X000 X000 000000 01
1	 0	0000000000X00	1
10000 XX000 000000X1
10X000 00000 0000001
11111111111111111111
