NO test_artifacts/valid.xpm
SO test_artifacts/valid.xpm
WE test_artifacts/valid.xpm
EA test_artifacts/valid.xpm
F 222,0,0
C 196,255,72

11111111111111111111
1 0000000000 00000 1
1XX000 000000	000001
100X000000000000	X 1
10X0 0 0 X00  0	0 01
100000000X0 0 000001
10000000 X0000000001
10XX0000X00000000001
10 0    000 000 X001
10000X0	0X00000000X1
1 00X00   000 0000 1
1 000000000X00X00001
100000000N0X00000 01
100X00000 0 0 00X 01
10	 00 000X00 0X0 01
1000000000	0 0X0X0X1
10000000000X0X000001
100000 000	000000001
1000X 0000 X00000X 1
11111111111111111111
