NO test_artifacts/valid.xpm
SO test_artifacts/valid.xpm
WE test_artifacts/valid.xpm
EA test_artifacts/valid.xpm
F 45,25,39
C 126,237,33

11111111111111111111
100X0 0000000000	 01
1000 00	0XX0000000X1
10000X0 0000X000  X1
1N000X00 0	000	00001
100X0000000	0000		01
1 00000000X 0000 001
100000000X0XX0XX 0X1
1 0	0  X 00XX0000 01
10000X00XX0000000X01
100X000 0000 0000001
1	00000X0	0 0	000001
100000000X00XX000001
10000	X	00 0XX0	0001
10000 X00X0X0 00  01
1000 0X 000XX0000001
100000000000000	0001
10000 0000	0 XX00001
100000000000X00X0 	1
11111111111111111111
