NO test_artifacts/valid.xpm
SO test_artifacts/valid.xpm
WE test_artifacts/valid.xpm
EA test_artifacts/valid.xpm
F 31,0,0
C 104,190,172

11111111111111111111
100 0000	 0 00	0 	 1
10000X0 00	 0XX00X01
1X0	0X0  0 0000	0001
10000000 00X0000X001
100000000		 0 X00001
10	0X00000X000X 0001
100000000000	0000	01
1 0000X	0 0000000001
100000000000000 0X01
10000	000X0X 000X001
1000 0000X000000XX01
10000XX 000XX0000X01
10000000000000000001
1000000 0000	0000001
1X00000000000	  0001
1000000000X00 000001
1000 0000N000	X 0001
1000 X000	0000000001
11111111111111111111
