NO test_artifacts/valid.xpm
SO test_artifacts/valid.xpm
WE test_artifacts/valid.xpm
EA test_artifacts/valid.xpm
F 176,193,212
C 108,203,70

11111111111111111111
10000000100000001101
11001001100000100001
10000010100100001001
10000010000010100011
10010000100111001001
11000000001000011101
10000110000010000001
10000000010000000001
10000000000100000001
10000010000000000001
10000010000001000011
10001001001010001111
11101100010100100001
10010010100100100011
10101000100001000001
10000000000000100001
100N0110010000000001
10000000100000000011
11111111111111111111
