NO test_artifacts/valid.xpm
SO test_artifacts/valid.xpm
WE test_artifacts/valid.xpm
EA test_artifacts/valid.xpm
F 208,213,148
C 198,122,204

11111111111111111111
10100000100000001001
10000001101011100001
11000001000101001001
10000010100001000001
11000000000010110101
10001100000000101001
10000001000000000001
10000101000100000001
10100000010000010001
10000000001000011001
10101000001010000001
10001000N00101000011
10000000001010001011
10111101001001000001
10000000100000000001
11000101000001110001
10100000001000000001
10000100000000001011
11111111111111111111
