NO test_artifacts/valid.xpm
SO test_artifacts/valid.xpm
WE test_artifacts/valid.xpm
EA test_artifacts/valid.xpm
F 179,11,154
C 57,248,78

11111111111111111111
1 0X0X0000000X0 00 1
1000 0000000 0000001
10X0 00000000 NX	001
100000000000000	0001
100X000 000 000 0001
10000000X0000000 001
100 00000000X0X000	1
1000000X0	X000X0 0	1
100X000000X000000001
1000000X000000 00001
100000 0000000X00001
1000 0	 00X0 00000 1
1000X0 0 00000X00001
100000X0XX00000X00	1
10000000 00 0 000001
10X000000000 0X00001
1 00X0 00000 0 00001
10000   0 00000XXX 1
11111111111111111111
