NO test_artifacts/valid.xpm
SO test_artifacts/valid.xpm
WE test_artifacts/valid.xpm
EA test_artifacts/valid.xpm
F 178,186,170
C 170,218,202

11111111111111111111
10000	0 00	0000000 1
10X00000	000	000XX01
1X	0 0X  0000 N00 01
100X	00000000000 001
10000000 000X00	0 01
100000000	0X0 000001
1000X0 000000	000 X1
1	0 000X00000XX00X01
1X0000  0000 000	0X1
1000	000000 0	 00001
10  0X00000000000001
1X0000	000X000	00001
100000X00X00 X 00X01
1000000 X	X000 00001
10X0 0000X0000000X01
10X0000 0XX0 X0000	1
100000X000  00000001
1 00000000X0000000X1
11111111111111111111
