NO test_artifacts/valid.xpm
SO test_artifacts/valid.xpm
WE test_artifacts/valid.xpm
EA test_artifacts/valid.xpm
F 207,113,114
C 148,136,76

11111111111111111111
1	0X00000	 000X000X1
100000	 0 0000000001
1X000000 XX0X000X001
1	00000000X000	00001
10000X0000XX0000	001
1 00000X000 00000001
100000 N0 00X000 001
100 00X00 0XX0000001
10000X00000 00000	01
10000X0  X000XX00001
10000000X000000000	1
1 000X0 00000	0X0001
1X	0 0	00 000000X001
1  0000000 000000001
10 00X000	0000 	0X01
10	0 000	0 000000001
1000	X000000	00000	1
1 X00 X0000 X00	0001
11111111111111111111
