NO test_artifacts/valid.xpm
SO test_artifacts/valid.xpm
WE test_artifacts/valid.xpm
EA test_artifacts/valid.xpm
F 196,160,64
C 141,225,67

11111111111111111111
1 X000000	00	00 00X1
1000000	0X0  X0 0001
10 	0000 0		00000001
10X0X00	00000 0 0001
10 000 0000000000001
1000  	0000  000	001
10000X00 0000 0X0 	1
100N0X000000X0000001
10X0000X000	0	00X001
10000000 0 0XX000 01
10000000X 00000000X1
100 000000000  00001
100X00000000X X0 001
10X00000 0	X00	X0XX1
1 0000X00XX00000X	01
10000 0000	000000001
10X0	  000000 	00001
10 X0000000000X00X01
11111111111111111111
