NO test_artifacts/valid.xpm
SO test_artifacts/valid.xpm
WE test_artifacts/valid.xpm
EA test_artifacts/valid.xpm
F 252,26,129
C 154,201,243

11111111111111111111
1 0000	0000 00000001
1000  000000000X0001
10	0X	X00000 0X	X001
10X0000		 0000 0	001
1 0000000 000 000 01
1X00 00X	000000000 1
1 000000000000	X00 1
100000 X0 000X000X01
1000000X0000 00X0001
10000000000000X 0001
1	0	0	0 000000000  1
10000000	0	0X0XX0001
100X00 0 000XX0000 1
100000X0000000 0 0 1
10 X 0NX00000000X001
10000 0000000X0 	001
100000 0 000X0000001
1X00000 	00000 00X01
11111111111111111111
