NO test_artifacts/valid.xpm
SO test_artifacts/valid.xpm
WE test_artifacts/valid.xpm
EA test_artifacts/valid.xpm
F 61,21,79
C 90,127,252

11111111111111111111
1000000	 00 0 000 01
1	0000		 000000X0X	1
10000	0X000 000000 1
1	00000000000 0 0001
1NX  00000X0000 0001
100000000	 	0X000001
1000X0	00000000000 1
10000X0	000000	00001
10  00 0X000 0000001
1X0000000000	 0 X001
1000000000000XX00001
1X000 0000000 	000 1
10000	X000	0X	0XX0X1
100X00000X000 00 001
1000000XX00	0 0 0001
1000000	0000000000 1
10000X00 0	0X 0 0001
1X000000000X00000  1
11111111111111111111
