NO test_artifacts/valid.xpm
SO test_artifacts/valid.xpm
WE test_artifacts/valid.xpm
EA test_artifacts/valid.xpm
F 27,51,208
C 255,227,125

11111111111111111111
1X000X00	0000 000001
10000	00	X00 00000X1
10	0X00X00	000000001
100 0000000000000001
10 		 000X00	0X0	001
1XX0	0 X0000X0000001
100 0000000X0000 001
100000000 0000000 01
1000 00000 000000001
1X00 0000000000000	1
100X  000000 0 00001
100000  0000XX000X01
1000000000000X0N		X1
1 00000X0X0000000001
10X0 00 000000000001
1X000 0	X0 00 XX00X1
1	0X0000X00 	 00 0	1
1 0 00X000X 000000 1
11111111111111111111
