NO test_artifacts/valid.xpm
SO test_artifacts/valid.xpm
WE test_artifacts/valid.xpm
EA test_artifacts/valid.xpm
F 18,0,0
C 96,75,211

11111111111111111111
10	0 0X	000 000X0X01
10	0X0X000000	XX0001
100X	 000X0000000X01
10	0000 000000000001
1  00 0X0 0X 	0 0 01
1N00000000000 X00001
100000X0000 	X000	X1
10000000 00000000 01
100000 X00 	X0000001
1000000000	 00000001
10	00 000000X000X0X1
1X0000X0000X00000001
10X00X000000	00000X1
100 0000000000000001
1000000X00000 	00001
1 0000000 0000X 0 X1
100000	00000X00X	001
10 000000X0000	00001
11111111111111111111
