NO test_artifacts/valid.xpm
SO test_artifacts/valid.xpm
WE test_artifacts/valid.xpm
EA test_artifacts/valid.xpm
F 226,82,112
C 127,138,120

11111111111111111111
10	X0000000 00000	01
10 0X	X00 0X00000001
10000000X 000000 001
100X 0 00000000	0001
1X 00	000	0000000001
1X000000 00000000 01
1	0X	00 0000XX000 01
1 00 0000X 0000	0 01
1X00000X00 000000 01
1X 00 0 000	 00XX001
1	00	 00000X   X0 01
1000000000 X000000 1
1000	0	00 000 X	0001
1X0 000		0X00X 00X01
1X  00	0000000000001
1000 00000000  000X1
1N000X00000 00000001
1000X0000000X00 0X	1
11111111111111111111
