NO test_artifacts/valid.xpm
SO test_artifacts/valid.xpm
WE test_artifacts/valid.xpm
EA test_artifacts/valid.xpm
F 93,35,108
C 180,122,3

11111111111111111111
100X0N000000000XXX01
1000X000 0000	000001
1 000  X00 000X00001
1X 00000000000000001
1000000 00000000 001
10000X000X 00 0X0 X1
100 00	0X000 0	0 0 1
1X00X 00000 XX0 0X01
1000000	000000000001
100000 00 00  0000X1
100 0000000000 0 001
10000000 00	 X0000 1
10000000000000000001
10 0XX000000000000	1
100000000X0 X0000001
1	00000		X000 000 01
1	00 0000X	X 0000001
10000 0000X0	0000001
11111111111111111111
