NO test_artifacts/valid.xpm
SO test_artifacts/valid.xpm
WE test_artifacts/valid.xpm
EA test_artifacts/valid.xpm
F 123,52,246
C 204,219,60

11111111111111111111
10010101110001000001
10000000000100000001
10100010100000000001
10000000000000000001
11001011010001100101
10011100010001000001
10101001100000100011
10111000000100000001
10000000000000110001
11000000100000001011
10000100000000011001
10110001000000100001
10000000001010000001
10000010010000N00001
10001011100100000001
10000001000000001001
10011001010001000001
10100000000000000101
11111111111111111111
