NO test_artifacts/valid.xpm
SO test_artifacts/valid.xpm
WE test_artifacts/valid.xpm
EA test_artifacts/valid.xpm
F 208,31,247
C 129,223,77

11111111111111111111
1000  000	 0 0X00001
100	00 0 	0X00X0 001
10	00 	X000	  0X	001
1 X0000X0X00000X0001
100X	 0X	000	00000X1
100X00000000 0XX0001
100	0X0	000000000 01
10X000000000000000X1
1000000 0 00N00 0	01
10 00	00000000X00X 1
1	00000 000X0000 001
1 	00 X000000000	001
100000X0000XX0000001
1X00000X0000000 0XX1
10000	X000000X00	001
10X00X00X0X000	0	 01
10000 000000000 00 1
1X000 X000 0000X00	1
11111111111111111111
