NO test_artifacts/valid.xpm
SO test_artifacts/valid.xpm
WE test_artifacts/valid.xpm
EA test_artifacts/valid.xpm
F 239,207,76
C 58,53,225

11111111111111111111
1000	00000 00000X001
10 0000000 00  XXX01
10	X0 0000 0 0X0 001
100000X00XX X00 X001
100000000000000	0001
1	0000000 000X000001
1000X00X000XX0000001
1000X000000000000001
10000000000	000000 1
10000 0000000X0 00X1
100 000	X00X0X0X0001
10 00	00XX000X000001
1000 0XX0 000	000001
1  0 00000000 	00 01
10N00X00X00 X0000 01
1000	00000 X000X0001
1	00 0X0X0000000 001
1X0000 0000X00000001
11111111111111111111
