NO test_artifacts/valid.xpm
SO test_artifacts/valid.xpm
WE test_artifacts/valid.xpm
EA test_artifacts/valid.xpm
F 127,184,215
C 162,60,102

11111111111111111111
10010000100100000001
10000000010000100101
10000000001000000001
10001100000000001001
11000000010010010001
10001000000000000011
10011000000001000001
11000000010000010011
10100100100000100001
10000000000110000001
10000000000010011001
10010000001001010001
11000010N00000000011
10000000000001001011
10001000101000000001
10011011010001000011
11000101010000000001
10010010000010011001
11111111111111111111
