NO test_artifacts/valid.xpm
SO test_artifacts/valid.xpm
WE test_artifacts/valid.xpm
EA test_artifacts/valid.xpm
F 62,0,0
C 58,194,84

11111111111111111111
10 000X		0X00000	001
100000 0X 0X00000001
1  0 000	000X00000 1
10000000	000000 X 01
100	0000000000X00001
1000X00X000000000001
1   000X0 000	000001
100000000	000XX000 1
1000000X000000000 01
1000 0000000000000X1
10000 00  0	0X 0X001
100000000 00000X00X1
1000000000X00X00 0X1
1000 0X00 0	0X0	00X1
100X N0000X 0000	0 1
100000000 00X0 X	0 1
10 0X000XX0X0X0 0 01
10000X000000000 0001
11111111111111111111
