NO test_artifacts/valid.xpm
SO test_artifacts/valid.xpm
WE test_artifacts/valid.xpm
EA test_artifacts/valid.xpm
F 19,183,144
C 233,37,221

11111111111111111111
10000000		 	00 00001
100X00 0000000000001
100X0000000000X00001
1  00 0000X	0 0XX 01
1	0 0000	000000X00	1
1 000 000000X 000 01
10X000 000 XX00 00	1
10X000XX000 00000X	1
10000000000000	X00 1
10	00 0 0 0000 00X01
1000000X00000000 001
1 0XX0X0000	0NX000 1
10X0X000X 00 X000001
1 00X00000	00000 0X1
1000000X000000000001
10000 0 00X0X0000001
100XX0 00000 0000001
100X000000000X0	 0 1
11111111111111111111
