NO test_artifacts/valid.xpm
SO test_artifacts/valid.xpm
WE test_artifacts/valid.xpm
EA test_artifacts/valid.xpm
F 79,88,3
C 219,36,247

11111111111111111111
10X 0000000X0X000001
10000000X0  0	000	01
10	00000  0X00 00001
1000X0000000X00X0001
10X000XX00000X0XX001
100000000000000X0 01
10 00	00 0000X000001
1000X  00 0X00000	01
10 00000000000000X01
1	0 0000	0X 00 	00	1
1000	000000000000001
10	00000 00000000001
1X00X0000000000000 1
10 0000  000000	00X1
1000000X00X0 00X0001
10000000 00000 0	X01
100	0 0X  00 0000 01
1	00	000000000N00001
11111111111111111111
