NO test_artifacts/valid.xpm
SO test_artifacts/valid.xpm
WE test_artifacts/valid.xpm
EA test_artifacts/valid.xpm
F 0,160,150
C 235,231,150

11111111111111111111
100X	0000000000 0001
1 000 0X00	000000XX1
100000000 00	XX000X1
1000	 00000000 X0 01
1  00X0 00 X00000001
100000000000000X 001
1000000000 000	00XX1
10 000 00 0XX0000X01
100 000000 000000001
10000X00000000000001
1 0 000000	000000001
100000000X0000000001
10000 X 	0 000000001
1X0000000 000	00	0 1
1 000 0000000000X0X1
1X0  000000 N0000 01
100X000000XX00 00001
10000000 0000	000001
11111111111111111111
