NO test_artifacts/valid.xpm
SO test_artifacts/valid.xpm
WE test_artifacts/valid.xpm
EA test_artifacts/valid.xpm
F 159,186,1
C 221,191,5

11111111111111111111
10X00000X00 X 000001
100X0	00 0X00000X 01
100000X0000X000 0001
1X0000X0  	0 0000001
1000 	000000  00X001
1000 000  	 00000001
1	0X 00000 0000 0 01
100000 00000000X0001
100000000 0  0000001
1000000000000000 001
1X0000X0000000XX0001
1 0 0 N00000000 0001
10000	0 X  00X0		 01
10 00000X000000	0001
10X X0000X0X000000X1
10 0X0000 0X000 0001
10000 	0  000X000001
10 00  0 000X0000X01
11111111111111111111
