NO test_artifacts/valid.xpm
SO test_artifacts/valid.xpm
WE test_artifacts/valid.xpm
EA test_artifacts/valid.xpm
F 0,134,47
C 111,80,132

11111111111111111111
100	000XX 00000000 1
10000	0000 0 00X0001
100000000	 0000000X1
1 0 00000000 	0000 1
10000000000000000001
100 0000	0	0 0000001
1 0	000000X000000001
10 00000 00000000X01
10000000000 0	000001
100	000000	000000001
1000	0000 X000	00001
1	00X000 0	00NX00XX1
100X0 0000XXX00	 0	1
1 00	0000000 	00 001
10000 00	X000000X0 1
10000000000000000001
10000000000000000001
1000 X 00 0X 0000001
11111111111111111111
