NO test_artifacts/valid.xpm
SO test_artifacts/valid.xpm
WE test_artifacts/valid.xpm
EA test_artifacts/valid.xpm
F 45,75,233
C 128,194,12

11111111111111111111
1000	000000000XXX0	1
1000000000	0000X0001
100X00N0X0 000	00001
1000000 00X 000 0001
1 X0X000	X0000000001
100X0X	00 0000000001
1000 XX00000X0X000	1
10000000 X00 0	00001
1X0X00 000000	0000X1
10000000 0 0X0X000X1
10000000X00000000001
10 0 00X X000000 001
10  X00000000 000		1
100000000000000000X1
10 X0000  0000 0X001
1 0X0 0	0X00XX0 	0X1
10000X00000000000X01
10 X0000XXX	X00X0 01
11111111111111111111
