NO test_artifacts/valid.xpm
SO test_artifacts/valid.xpm
WE test_artifacts/valid.xpm
EA test_artifacts/valid.xpm
F 143,0,0
C 95,224,55

11111111111111111111
10000000000 00000001
1000X0000000 0X 0 X1
1000000000000000 X01
1XX0X0 	00000 000001
100000XX0	000X0 	001
1X000 0X0X00000X0001
100000 X000 0000X001
100 000	0000000000	1
1X00	00000 X000 0001
1000	0000X00 XX000 1
1	 0X	X0 000000 0 	1
100X000000 000 00001
100X000000000 0X00X1
100000	0	00 00	00001
1000X00 0 0X00000001
1X000000X0 00000 001
1000X0X00000 000	001
1000000000000 00N001
11111111111111111111
