NO test_artifacts/valid.xpm
SO test_artifacts/valid.xpm
WE test_artifacts/valid.xpm
EA test_artifacts/valid.xpm
F 105,115,166
C 145,211,133

11111111111111111111
10000000X0X 0X000001
1	X	00XX 0X	00X0X	 1
1XX0 00000 000000001
10	0  0	000000000001
1	0 000  0 00X0 0001
10000000000000000001
1000 000000000X 	001
10	00X00000000 	0001
1000X  0	0X 0 X0X	01
1000000 00000X0	0X01
1000000	00 0N0000001
100000000000	00X0001
1000 00000000	0X00X1
1000000	000X00000X01
1000000X0000000	00 1
1	  000X000	 X00	 01
10X0X00	000000	0	 01
1000X0X0  00XX000 01
11111111111111111111
