NO test_artifacts/valid.xpm
SO test_artifacts/valid.xpm
WE test_artifacts/valid.xpm
EA test_artifacts/valid.xpm
F 177,23,236
C 31,243,14

11111111111111111111
1	000000	00 0 00X001
10 X00000X0 0 X00001
10 00000 00	0000X0	1
10000	00000X00000001
10000000000X000 0001
10	00 000	0 00 0 001
100 0X0000X0  000001
10		 0000 0000		0X01
10000X00X0	000000001
100 	00XXX0000XX0X	1
10XXX0 00 0 00000001
10X00X0X000000000001
1000 000	0   X0XX001
1000 0000	00X000X	01
100000000		0000	0001
100	0	0 0000 0000 01
10 00 00000000N00001
10X0 00 0000 0  00	1
11111111111111111111
