NO test_artifacts/valid.xpm
SO test_artifacts/valid.xpm
WE test_artifacts/valid.xpm
EA test_artifacts/valid.xpm
F 92,21,25
C 140,229,246

11111111111111111111
100	0 000X		00000001
1 N	00000000X0 	0X01
1 00X0000000 00 0001
10	00000000	00000001
1 00000XX0	0 0	000 1
10000X0X000000000001
10000 00000000X00  1
100000	0X000000 0	01
100 0X00000000000001
10000X00X000000	 001
100000000000000X	0	1
10000	0 00X0   000X1
1000X0 00    0000001
1000000 00 00X000001
100000X000000 0 00 1
1 0000	X0X0 X0X00001
10000 X 0000X0000001
1000000X000 0 0X0 01
11111111111111111111
