NO test_artifacts/valid.xpm
SO test_artifacts/valid.xpm
WE test_artifacts/valid.xpm
EA test_artifacts/valid.xpm
F 10,,0,0
C 146,216,14

11111111111111111111
1X00X000 X 000000 01
1 0 00000 0000000X01
100000000000X	0000	1
1000XX000000000X00 1
10 N0X000	00  0  X 1
1000XX00	00000000001
1 0	000 0X0000000 01
100X0000000000000001
100000 00X000X 	0001
1000000X  0X00X0 001
10000	00000X00X0 	01
1X0	000	00000X00X	01
10 00000X 0000 00001
100	000X 00000000 01
100000X0X0000X000001
10X00000 00000X00001
1 00X 0000 	X0000001
1000000 	 	000		0	 1
11111111111111111111
