NO test_artifacts/valid.xpm
SO test_artifacts/valid.xpm
WE test_artifacts/valid.xpm
EA test_artifacts/valid.xpm
F 93,93,235
C 66,189,143

11111111111111111111
11100011000000100011
10100000000000010101
10000010000N01001001
10000001000000000001
10001000000001000011
11000000000000100011
10001000101001001011
10111000000110000001
10000000000010001001
11000000010001010001
11000001000000001001
11000000010000000001
11000001100000000011
11011100000000000001
10000101001110001001
10000000000000000001
10110000000000000001
10001000100010000001
11111111111111111111
