NO test_artifacts/valid.xpm
SO test_artifacts/valid.xpm
WE test_artifacts/valid.xpm
EA test_artifacts/valid.xpm
F 106,,0,0
C 242,73,253

11111111111111111111
1000000X	000 0	00001
1X0000000X000	000XX1
1	00 00000	000000001
10000000X000X000 001
1XX000 0 0 00 0 	001
1000000X0000000	0XX1
1 00 000000	0000	 	1
10X0000X0 0000	00001
1	X000000 	0X 000001
100X00 0000X0 0 0001
1 0 00000X00X 00XN01
1 00 00X   000000001
1000000000	 000	  01
1 X00000000	0XX0 001
10	00000X000 00  001
10000000000	00000001
10	X00000X000000 001
10 0000000X000000001
11111111111111111111
