NO test_artifacts/valid.xpm
SO test_artifacts/valid.xpm
WE test_artifacts/valid.xpm
EA test_artifacts/valid.xpm
F 96,,0,0
C 192,1,136

11111111111111111111
10X00000X0	N00 X 001
100X 000	X0000000X01
100000	0000	0XX00X01
1 00 0000000000000X1
10000000X00		0000001
100000000000XX0X0001
1	XXX00000X00	0000	1
1X00000	  X0 0  0001
100 0000	0000X0000	1
1 0000000X 00X000001
1000000 00000X0000 1
1 	0XX 0000000000001
1	0X0000X000000000 1
1 0000	000 0X0000001
100000000 0	 00 0 01
10000	00000000 	0 01
100X00 000000000 001
1 0X00X 000 0000XX01
11111111111111111111
