NO test_artifacts/valid.xpm
SO test_artifacts/valid.xpm
WE test_artifacts/valid.xpm
EA test_artifacts/valid.xpm
F 49,0,0
C 202,51,185

11111111111111111111
100XX0 	 	00 00000X1
1 000000000X0X0X	001
10000000		0000X 0X01
1 0		00000 00 00	001
1X0000 0 000000N0001
1X000000000000XXX001
10X	00000 0 0  00 01
1X0 0X0	00  0	0 0001
10 0000X0 0X00000001
100000000000000	00X1
1X00000 00000000	001
10000  00000000000X1
1	00 00000X 00X00X	1
1X000	 000000  00001
1000X00X000000X0 XX1
1X000000000X00000001
100000 0000000000001
1 0000X00000XX	00 01
11111111111111111111
