NO test_artifacts/valid.xpm
SO test_artifacts/valid.xpm
WE test_artifacts/valid.xpm
EA test_artifacts/valid.xpm
F 225,101,93
C 214,190,9

11111111111111111111
1000	 00000X00 X0001
10X0X0X00  X0X0	0001
10  00 00000 0 0 001
1X000000000000000001
10	000000X0	00X000 1
100000000 000 X00001
10000	00 0 000000X01
1000 X000X0	000X0001
100000000000 X	00001
1 000000000000000001
1 000 000 000 0	00 1
1X000X000000N0 00001
1	00XX00000 00X00001
1X0 00 0	000000000 1
100 00	0   00	000001
1X000 0	000000 00001
1X 0 0X00 000	0000X1
100000	00X X000X00 1
11111111111111111111
