NO test_artifacts/valid.xpm
SO test_artifacts/valid.xpm
WE test_artifacts/valid.xpm
EA test_artifacts/valid.xpm
F 161,152,188
C 142,247,99

11111111111111111111
10000000000		00000X1
1X00000 0 X000	X0  1
1000X00000000	0X00 1
1000X0 000 00000	 01
1000000000 0X0X  001
10 00 	0XX000X0X0001
100N00000 X0000	 001
10	00 000X0000X000	1
10000 00000000 XX001
100000XX0X0000000XX1
100000	00X0000000001
1 X0 0000 000	00	0X1
1 0000000 000X000 01
10000 0000000	000001
10		X0XX000000 00001
1000 00000 000X00 01
1000X0	00X00X0	 00 1
1000 00 00	000 X0001
11111111111111111111
