NO test_artifacts/valid.xpm
SO test_artifacts/valid.xpm
WE test_artifacts/valid.xpm
EA test_artifacts/valid.xpm
F 68,,0,0
C 198,120,59

11111111111111111111
10	0X 	  000000	0	01
10X00 X000  00000001
1X00000X00000000		 1
100000X00	00	0X0X001
1000000000	000000001
10	0 000000000000001
1000X	0000000000X001
1000 0	00X0 00000 01
100000X 00 000000001
10X000X	0 00000XX001
10000 0000	 00000001
100 00000X0X0000 001
1000X 0	0	X0	000 0X1
10000 X00	0000 00001
1N000000X000000X00 1
10000   0 0	00  X001
1000X	0		X0 00000 X1
10000	00 00000X00X 1
11111111111111111111
