NO test_artifacts/valid.xpm
SO test_artifacts/valid.xpm
WE test_artifacts/valid.xpm
EA test_artifacts/valid.xpm
F 209,140,30
C 40,4,188

11111111111111111111
1	 0	00X0 00000000X1
1000000000	00000X001
1000X 00XX000X0X0001
100000 0 0 0 00000X1
1	0000X00X000000X001
10	0000X0X 0000	 0X1
10X0X00000000 	 0001
10000X 00X000	0X	0 1
10X00 	000000000X0 1
10X 0000X0000  0XX01
1X000X0	0 000X0X0	01
100X0000000	000	0X 1
1000 0000XX00 000001
1N000 0X00X0X0000001
10	0X0X0000000000001
1000000 00 XX	000001
1 00000000 0000	0001
1XX0 00  00 00X00001
11111111111111111111
