NO test_artifacts/valid.xpm
SO test_artifacts/valid.xpm
WE test_artifacts/valid.xpm
EA test_artifacts/valid.xpm
F 5,144,50
C 156,89,28

11111111111111111111
11000000000000000001
11001000010000000001
11100001000000000001
10000001001000001101
10000000001000000101
10010010001000110001
10000000100000000001
11001100001001000001
110000010101000N0001
10001100000100000001
10000000010000000011
10000001000010100001
10100000000001011001
11100010000011100101
10100000000100000101
10010001001000000001
10110000100000000101
10000000000000000101
11111111111111111111
