NO test_artifacts/valid.xpm
SO test_artifacts/valid.xpm
WE test_artifacts/valid.xpm
EA test_artifacts/valid.xpm
F 21,157,153
C 223,129,84

11111111111111111111
10100010001100000001
10000010000000000101
10100000000100000101
10001000100000000001
10000000000000000011
10100000010001010001
10110000101000000011
10010000000100000011
10000101001000000001
10011101000000000001
10000000100000000001
10100001010000000001
1010N000000000001101
10000001010000000001
10000100000010000001
11000000011010000011
10100010001100101001
10000000111010000101
11111111111111111111
