NO test_artifacts/valid.xpm
SO test_artifacts/valid.xpm
WE test_artifacts/valid.xpm
EA test_artifacts/valid.xpm
F 4,0,0
C 126,125,238

11111111111111111111
10000X0000	000X0 001
10XN0000X000000 X001
1000X0000 000X000001
10000	 0 00000 0	001
1000 00000000000	001
10XX000000000X   0X1
10X0X000	00 0 00X 	1
1X00000	X000000X00 1
10000000000	00000001
10000000	00000	0X001
1000 0 00X0000X 	001
1000X00 00000X X00 1
1000  00	0 0000X00X1
1X0000 00000X0 00XX1
100000X00X00000	0001
10X0		 00000000000	1
10 000000 0000 00001
100000	00X00000 0001
11111111111111111111
