NO test_artifacts/valid.xpm
SO test_artifacts/valid.xpm
WE test_artifacts/valid.xpm
EA test_artifacts/valid.xpm
F 77,215,137
C 49,200,107

11111111111111111111
1 0000X 000000000X01
1 00 N000X00X00000 1
10 0000X	 000X0 0001
100X00000X0X00000001
1 00000XXXX000	000X1
1000  0X0XX00 XX00 1
1	00000 000000000001
10000000X X000	 X0X1
100000000X0X	0X00001
10000 000X0		00 0001
1  0	0000 0000	00XX1
1000	  000 000000X 1
100X0000000 0			0	01
10000X000X0	0XX0 001
1X000000X0	0 00 X001
100X 0X0	00 00000	01
10X 0000000 X00	0001
10 00XXX000000	X0001
11111111111111111111
