NO test_artifacts/valid.xpm
SO test_artifacts/valid.xpm
WE test_artifacts/valid.xpm
EA test_artifacts/valid.xpm
F 76,176,236
C 243,139,138

11111111111111111111
10 0000 0X00XX0000	1
10 0000	000 000X0	01
100000X000X0X0X00X01
10  	00X0000	 000001
100	00000000000000	1
100000000000 000 0 1
1000000000 00000N0X1
10  00000 00 000  01
100000000000000	 001
1X	0 000000X0	00 001
1	X0X0000000 0000001
100000X	000000000001
1000 0	0000X000 0001
1 000XXX0X0000000001
1X00000X000000000001
10X000000000	X00 001
10000000 X0000000001
100000000  0 0  0001
11111111111111111111
