NO test_artifacts/valid.xpm
SO test_artifacts/valid.xpm
WE test_artifacts/valid.xpm
EA test_artifacts/valid.xpm
F 251,81,19
C 197,31,178

11111111111111111111
10001000010100000001
10100100101100000101
11010000000000000001
10000001000000011001
1000N000000000110001
11000000000000000101
10010001111100100001
10000000000000000101
11000000011000000001
10001000000000010101
10000000010000000001
10001000000010110001
10001000101000000001
10000000010000000001
10001010000010000001
10100000000010000001
10000000011010001001
10100000100000000011
11111111111111111111
