NO test_artifacts/valid.xpm
SO test_artifacts/valid.xpm
WE test_artifacts/valid.xpm
EA test_artifacts/valid.xpm
F 61,116,69
C 173,181,166

11111111111111111111
11011010100100000001
10100100101000000001
10000000100000000101
10000100100001100001
10000110001000101001
10010000000000000001
10001000001000001001
10000100000000011001
10000010000000010001
11000000000001000001
10010000N01101000011
10100000000000000101
10000000100000101111
11010000010000001001
10000110000000000001
10000010011001000001
10000010000011000101
10000100100000000001
11111111111111111111
