NO test_artifacts/valid.xpm
SO test_artifacts/valid.xpm
WE test_artifacts/valid.xpm
EA test_artifacts/valid.xpm
F 62,104,109
C 71,87,222

11111111111111111111
1000000X00000	0 0  1
1000000000  00 0X0X1
10X00000 0000 0X0001
1 0000 00000 0000001
1X	0	0X0X0 0000X0001
1000	X 00 000000X001
100X000XX00000000X 1
10N0 00 0 0000000	01
10000 0	 00000000001
100XX000 0X 000	0001
100000X0 X0 0 000X01
100	X00000000000X001
10000X		0000000 00X1
10000000000000  	001
10 X	0 0000 0000	0	1
100000X000	000000001
100000	00X0	00X0X001
1X000 0	00 00	 00 01
11111111111111111111
