NO test_artifacts/valid.xpm
SO test_artifacts/valid.xpm
WE test_artifacts/valid.xpm
EA test_artifacts/valid.xpm
F 4,72,130
C 199,42,255

11111111111111111111
10111000000010000011
11000000100001100101
11010000010000000011
10011000000000000001
10001010010100000101
10010011010100000001
10000000000000001001
10110000011000010011
10000000000000010001
10010000000000000011
10011000000000000001
10001100010000000011
10000000000000100001
10010000000011000N01
10010101000000010001
11000000000001010111
10001000010000001001
10000000010000000101
11111111111111111111
