NO test_artifacts/valid.xpm
SO test_artifacts/valid.xpm
WE test_artifacts/valid.xpm
EA test_artifacts/valid.xpm
F 140,135,83
C 91,49,151

11111111111111111111
10XX0000000000	X 001
100000000	0000X0X  1
100 000000	0 	0X0 X1
100	0000000X00000001
10	 0X 0000X0X000001
10000000 0 0 0	00001
1 0X00X000 X00000001
10000X0000000	0 0001
10	00 X0	00 000000 1
1000000 N00X 00000 1
10000000	0000 XXX001
10000000XX0000000001
100 0 X0	00 X 0 0001
100X0 000X0000000 01
1000000000X0X00 	001
100 0000X0000 000001
100X0000	  00000X001
1	0	0X0 0000	00XX	01
11111111111111111111
