NO test_artifacts/valid.xpm
SO test_artifacts/valid.xpm
WE test_artifacts/valid.xpm
EA test_artifacts/valid.xpm
F 102,145,212
C 181,139,7

11111111111111111111
10000XX00 0X00	0X0	1
1 00	00X000000000001
1 X 00N0000X	00X0	01
1000 0000000X00  001
100000	 00 00	0X0001
100 000000 000000001
100 00 0 000X0 00001
1 0 	000000	X	00 001
100		00000  00 	0001
10  00X 0 X 000 0001
100X 0X00000	0000001
100	000000 XX0000001
1X0	00 00 0X000000 1
1000000000000000 001
10000   00000000X001
10000000X0 000000001
1 00X 0 	000X0  0 01
10XX000  000	0 00001
11111111111111111111
