NO test_artifacts/valid.xpm
SO test_artifacts/valid.xpm
WE test_artifacts/valid.xpm
EA test_artifacts/valid.xpm
F 88,90,177
C 90,212,16

11111111111111111111
11000010000000100001
10100100000000100001
10011000000001000101
10101000000010000001
11000000000011000001
10000000001010010011
10000000010100000001
10000011100010000001
10000001000000000101
10000011100010000011
10000100100010000101
11001001100000100001
10010010010110001001
10000000001000001001
10000000N00100100101
11000000000000000001
10000010100100100001
10000000000001000001
11111111111111111111
