NO test_artifacts/valid.xpm
SO test_artifacts/valid.xpm
WE test_artifacts/valid.xpm
EA test_artifacts/valid.xpm
F 95,74,234
C 131,173,130

11111111111111111111
1000000000000 000N01
100 X0000000X00X0001
1000000 0XX0  000001
100X00000X000000	001
10	0000000X0 X000X01
100 000X000000 	0001
1	00	000	0000  00  1
10	0000	00XX0000 001
100X00 X0	0X00000 X1
100	00000X00  00	001
10000000 000X 000  1
1000000000 00000X001
100XX0000000000 0	01
10 0	00000 000000001
10X 000000000X000001
100 X00X 0  00000	01
100 000X0  00X 0	X	1
100000000000000000	1
11111111111111111111
