NO test_artifacts/valid.xpm
SO test_artifacts/valid.xpm
WE test_artifacts/valid.xpm
EA test_artifacts/valid.xpm
F 148,167,194
C 35,254,47

11111111111111111111
1 00000 000000X00001
1X0000000X000 00X001
1 0X000X000 X0N00001
100000	  0   000 001
1000X0X000X  X000001
1000X000X0000 0000X1
100	0000000X0000 001
100X0 00000000000001
1 0 000000X0 	 00X01
10000 0 0X00000	0001
10000000000000000001
10X0 0000000		000001
10 X00 0000X00X0 001
1 000	00000000000001
10000X00000X00000001
100X0 X000 00 X000X1
10 0X000 000	0 	0001
1000	000	0 000000001
11111111111111111111
