NO test_artifacts/valid.xpm
SO test_artifacts/valid.xpm
WE test_artifacts/valid.xpm
EA test_artifacts/valid.xpm
F 81,,0,0
C 200,25,141

11111111111111111111
1	0000000X0	0 0  001
100 0000000000000001
100000000 00	0000X01
1   0XXX0000 0000001
100 00	0000000X00001
1 00X0	00XX00000X001
10000000000XX0000001
1000000X00000	000 01
1X	00X00000000000001
100X00X00X0000000001
10	0X000X00XX00000X1
10000 00000X00000001
100000	000  0000XNX1
1000 0 000	 0X0	0 01
10  000 0000X0XXX0 1
1 0	000XXX0XX0000001
1000000000X00X00	001
1X0000X0000000	X00 1
11111111111111111111
