NO test_artifacts/valid.xpm
SO test_artifacts/valid.xpm
WE test_artifacts/valid.xpm
EA test_artifacts/valid.xpm
F 102,172,198
C 96,122,84

11111111111111111111
10 00	X0X00000X00001
1000000	000000 000X1
1000X 	000X	0X00 001
10X00000X000 0X000 1
10000000000000000001
1000000 00000 000001
1 00 0 X00000 000001
1000X X00000X0000001
1	0000X00000 X0	0001
100 0000000000000001
100000000X0000000001
100X0 	  	 0	 0X0	01
100X0X00XX00 N   001
1X00000000	000000001
100X 000	00000000001
1X 00000	000	00X00 1
10000X0000 00X 00001
100 0000 00000X00X01
11111111111111111111
