NO test_artifacts/valid.xpm
SO test_artifacts/valid.xpm
WE test_artifacts/valid.xpm
EA test_artifacts/valid.xpm
F 33,129,101
C 38,63,89

11111111111111111111
10001000000000000001
11010000000011001101
11000000000100010001
10000000000000101101
10101000010001100001
10100000001000001001
11000011000000000001
100N0100000100000001
10000000000000000001
11000000000000001001
10000000000101010101
11000000100000000001
10000000100100000101
10100010000100010111
10100000000001100001
11000000100000100001
11000000000001000001
10100000000000000101
11111111111111111111
