NO test_artifacts/valid.xpm
SO test_artifacts/valid.xpm
WE test_artifacts/valid.xpm
EA test_artifacts/valid.xpm
F 243,123,221
C 43,42,242

11111111111111111111
11001000000110001111
10000000001000010101
10100000000011010001
10100000010010000001
10110000000010000001
10010000010001000011
11000000000000000001
10000000000100001001
11000000000000000001
10000000000000100001
10000001010000000001
10000000000011100001
10000001000000000101
10000N01110000000001
10100000000001110101
10000110000100011101
10110100010010000001
11000100110100101101
11111111111111111111
