NO test_artifacts/valid.xpm
SO test_artifacts/valid.xpm
WE test_artifacts/valid.xpm
EA test_artifacts/valid.xpm
F 119,0,0
C 100,250,37

11111111111111111111
10000000X000	  00001
1 00000000X0  000001
10000000000 00N  001
1X000	X0000000000001
1X00000	000X00X  0X1
100 0X0000X00	X00001
1X0XX0X0000000000001
100X00	00X000XX00 01
10000X00 000X	0X0001
10			000000000	00 	1
1 000X X00X0000	0001
1000X X000X000000 01
1 000	 000	000 0 001
1000000X000000 0	001
10 	000000000000 001
100000	0000 X0000001
1 000 0000 0	0X0 001
1X 00000	00 000000X1
11111111111111111111
