NO test_artifacts/valid.xpm
SO test_artifacts/valid.xpm
WE test_artifacts/valid.xpm
EA test_artifacts/valid.xpm
F 251,,0,0
C 32,132,206

11111111111111111111
1 00000000000 000 01
1000X00X0XX 0 X00001
1X0000	000X0 00 	001
10000 0000000000X0 1
10X000000 000XX0X  1
10 000XX000X00	000 1
1000000X000000000X01
100XX00000000  0X0 1
10000 00	000 	 0 001
1000000X00	000N 0001
10000000X0 X0X000001
10 0	0X0000 0		 0X01
10000000 000	00 0001
10X0 000	0	000000001
1000000 0 0000000001
10000 X000X000000001
100000000000000  001
1 0000 00000X00X0001
11111111111111111111
