NO test_artifacts/valid.xpm
SO test_artifacts/valid.xpm
WE test_artifacts/valid.xpm
EA test_artifacts/valid.xpm
F 60,115,25
C 173,156,111

11111111111111111111
10000000001001010001
11000011100100000001
10000000001000100001
100000000100N0000101
10000001001000100001
10000100000000000011
10000100000000000001
10000000000100000001
10000000000001010101
10001100000010101001
10000101010000100001
10010001000001000101
10101000000100100011
11010010000100001001
11000010000000000001
10001000000000000011
10000100000011100101
10000001000001000001
11111111111111111111
