NO test_artifacts/valid.xpm
SO test_artifacts/valid.xpm
WE test_artifacts/valid.xpm
EA test_artifacts/valid.xpm
F 39,54,163
C 89,239,110

11111111111111111111
100000000000000	00X1
10	0000X 0000 00 001
10000000X0X	000XN001
100000000	000 00 	01
1000 0000X000 000X01
100000 	 00000000001
10X00000 00X0  00 01
100000000000X0X0 001
1X00X000	0000X000001
1	00000000 000X000	1
10000	0X000000000001
10000000X  00 000 01
1000000 	0000 0000	1
100000000X0X0000 001
100 00000 0 000000 1
1000X	 00	000X00 0 1
10000000000000000X01
1 00X000X000X00XX001
11111111111111111111
