NO test_artifacts/valid.xpm
SO test_artifacts/valid.xpm
WE test_artifacts/valid.xpm
EA test_artifacts/valid.xpm
F 3,95,81
C 129,29,83

11111111111111111111
10X	0	00000000000001
1 00000  0X000000X 1
1  0000X 0000		 00X1
1X00000000X	000	0001
10 000000000000X0001
1X00 00X000	000	0X01
10000		X0X000X0X0 01
10 XX00X000000X	0001
100X000000 00	00X001
10		000000000 0X0001
10000000 00X00000	 1
10 000000000XN000001
1000000 0000000000 1
10X0	0 0X		 0000 	 1
10000 X0000	00000	01
1000 00	 0000	0 0001
1XX000000  X00 000X1
1 000 0X0000000X0	01
11111111111111111111
