NO test_artifacts/valid.xpm
SO test_artifacts/valid.xpm
WE test_artifacts/valid.xpm
EA test_artifacts/valid.xpm
F 171,96,29
C 135,177,66

11111111111111111111
10101000001000000001
11100001100011000101
10111101000100001011
10000100010100000001
10000000000100000001
10110000100000N00001
10000111100000000001
10000000010000000001
10000000000000100011
10011000000000000001
11010100000101001001
10000000000000000001
10000100000110000001
10010010100000011101
10000000011000001001
10100000000110000001
10000100000000010001
10100000000000000101
11111111111111111111
