NO test_artifacts/valid.xpm
SO test_artifacts/valid.xpm
WE test_artifacts/valid.xpm
EA test_artifacts/valid.xpm
F 56,245,43
C 55,90,11

11111111111111111111
10	00X	0X 000X0 N001
1000 00000X00000 001
10000		00	 00 000001
1000  X000 0X000X001
1X00 00000	0XX0000X1
100000000 0000000X01
100000 000X0000	0 01
10000000000X0 	X0X01
1 X000 0X0000 000 01
1X0000000000	00 0 01
1	0000000	 00 000 01
10000 00 000000000	1
100 0000000000X00001
100000	0X0000XX00001
10 0000000000000 001
10X0X 0000X0  00X001
1 0000X00000000000X1
1X000000000000X0  01
11111111111111111111
