NO test_artifacts/valid.xpm
SO test_artifacts/valid.xpm
WE test_artifacts/valid.xpm
EA test_artifacts/valid.xpm
F 225,,0,0
C 130,195,86

11111111111111111111
1	0000000000X0000001
10	X000000X0X0000001
1000000X0000000000X1
10000000X00000000001
1	000X000000	 000001
1N00 0000 0000000001
10X 000000000X000001
1	 0000000000X0 0 01
10X 0 	0	00000X X0X1
100 00  000X0X000001
10000000X00000000  1
1000X0000000X000	X01
10X0000 0 0 000	0001
10000000   0	X000001
10 00X00000X000000 1
1000000  X0000	00 01
1X00000000X00X0 0001
1000000X000000	000 1
11111111111111111111
