NO test_artifacts/valid.xpm
SO test_artifacts/valid.xpm
WE test_artifacts/valid.xpm
EA test_artifacts/valid.xpm
F 85,244,173
C 7,130,187

11111111111111111111
1000000000 00X 0 0X1
1000000 0 	000	00X01
1000000000 000000 01
10	00000 000X0000001
1000 0000000	000	001
1X00NX00X000X0000001
1 0000000000	000X 01
10000 00000000000	01
1X0	00000X0 000	X001
1000X0000X00000X0XX1
10X00000 0000	000001
10000		00X0X00000001
100XX0000	00000000 1
100000 0000000000001
100000000000 0000001
1 0 X00 XX00 0X000 1
10000	00X0X0X0 0	0X1
10	0X00000 0000X0001
11111111111111111111
