NO test_artifacts/valid.xpm
SO test_artifacts/valid.xpm
WE test_artifacts/valid.xpm
EA test_artifacts/valid.xpm
F 35,,0,0
C 128,96,146

11111111111111111111
1 0000X00000	00 0	 1
10 0X0000X000 NX0	01
10000X0000 	00000001
100000 0000	00		 001
10X0000	X000XX0X00	1
1000  00000000000001
100000 000000X000001
10X0	000000000000001
100000X00	00 X000001
1	 00 00000X000 0001
10000000 00000000X01
100	0000000 000 0001
1000000	X00000000001
1 00	0 0000 00X00001
100	 000X0X0  	00001
10X0000000 0X0000001
10 00000 000 00 0001
10X0X000	0	000  0001
11111111111111111111
