NO test_artifacts/valid.xpm
SO test_artifacts/valid.xpm
WE test_artifacts/valid.xpm
EA test_artifacts/valid.xpm
F 181,146,251
C 184,111,41

11111111111111111111
10000  0 0X0000	0001
10X000X00X000	000001
100	0000000000000001
1000000 X0X00000	0X1
100X 	 0000000X0X X1
10X0000000 X0000	001
1 000 0		00 000000	1
1X00000 00	 000000X1
100000000	00 00	X0 1
100  0000 0 00000001
100000X0000 0	000001
100000	00000000000X1
1000	 00XX00000 00N1
10	000XX00  00 	0  1
1X00000	0000X0000001
100X0000X0000000	0X1
100000000	0000000001
10000 00000 00 00001
11111111111111111111
