NO test_artifacts/valid.xpm
SO test_artifacts/valid.xpm
WE test_artifacts/valid.xpm
EA test_artifacts/valid.xpm
F 56,,0,0
C 81,14,142

11111111111111111111
1000000	NX0XX00 0001
10000 000	00	0000001
100000	00000X 0 0001
1000XX000X	0000 0X01
1XX0000000 0X00 0X 1
100X000000000 0X00 1
1 000X0000000 000  1
1000000	000X00 00001
100X0X0	000000000 01
10	0	0  0	0000X0 X01
1X0 0X0 00X000000001
10X00	00 00000 00001
100 0X 0X0000X000001
1	000	0X	000X000		01
1000000	0 0X0	000X01
10000000000000000001
1X0X000 0X0000 00001
1000000000X00X0 0001
11111111111111111111
