NO test_artifacts/valid.xpm
SO test_artifacts/valid.xpm
WE test_artifacts/valid.xpm
EA test_artifacts/valid.xpm
F 137,,0,0
C 102,203,157

11111111111111111111
10000000000	   00001
1XX00 0000X00X0X0X01
100000000000X00	00 1
10X 00 0000  0000001
10	000 X000000X00001
100000000000000 0001
100	N00000 0 0000 01
10X00000000000X00001
1X000X00000000000001
10 000	00000 00000X1
10000	00000000000001
10000 0X0000X0XX 001
100X0000	0X0 00000 1
100X 0000X00X00 0001
100000 0	0	0000000 1
10000X0000	 000000X1
1000000 000	X00000 1
100X000000 000000001
11111111111111111111
