NO test_artifacts/valid.xpm
SO test_artifacts/valid.xpm
WE test_artifacts/valid.xpm
EA test_artifacts/valid.xpm
F 39,158,233
C 9,214,106

11111111111111111111
10000XX 000 00000 01
10000000000X0X000001
1 000000000 000	  X1
1 00X00000	000 NX001
1000000000 0X0	00001
1 	000000000000 X001
10 000 0X 000000X001
1X 00000000X0000 0X1
10 	00000X000 0 0X01
1X00	0000	0000 000	1
10 0000 00 00 000001
100	000 0000 00X0X	1
100000000000 0000	01
10000X0000X0000	00 1
1000000X000 X0000001
1 0XXX000X0X0X0000 1
1X00	0 0X0XX	0000001
1 0XX00000000000 001
11111111111111111111
