NO test_artifacts/valid.xpm
SO test_artifacts/valid.xpm
WE test_artifacts/valid.xpm
EA test_artifacts/valid.xpm
F 160,229,32
C 11,228,53

11111111111111111111
100	0000XXX0 00 0 01
1 0		0 000	00 0X0001
10000 0 000 00 00001
1 X000X 0 0000000001
10	00X00	N000X000001
10000X00000	00000 01
1000000	0	000 X0 0 1
1	0	00000X00000X0001
100000 000X 00000	01
1000000000000 0 0001
1000 000000000000X01
100 0 000		 000X 001
1000 0X000 000000001
100000000 00 X000	 1
10 	 00000000X000 01
10 000 0000000000	01
1000000X000 00 	0001
100000	000000X0  001
11111111111111111111
