NO test_artifacts/valid.xpm
SO test_artifacts/valid.xpm
WE test_artifacts/valid.xpm
EA test_artifacts/valid.xpm
F 239,206,241
C 137,145,199

11111111111111111111
10000100000000000001
11100100101000001101
10000001000001000001
10000010000000000001
11000001100000000001
10100N00000001000001
10010001000001000001
11000000000000000001
10001000100010100001
10100000000000000001
10000000010000001001
10010001011000010001
10000000000100010001
10000000000000100001
10010011101000010011
10000000000000000011
10000000000000001001
10110101100001000111
11111111111111111111
