NO test_artifacts/valid.xpm
SO test_artifacts/valid.xpm
WE test_artifacts/valid.xpm
EA test_artifacts/valid.xpm
F 252,152,99
C 94,233,103

11111111111111111111
1 00	00X0	 0 0000001
1X 	00X000X0X  00001
100XX00	 0 000X00001
1 00000X 000000X0001
1000000	00X0N0  0001
10 0 00000000 	0X0X1
10	0000000 X000 00	1
1	00000X0	00	0XX0001
100000000XX00  0X001
1X  00000XX0000 X	01
100 0X000X XX00000X1
1X00X0000000	0X00X01
10 000000000000000	1
10	0000 X 0	000 X0X1
1000000000  0   0X01
10		000 000000X00001
100000	00	 000000001
1000000000XX00X000X1
11111111111111111111
