NO test_artifacts/valid.xpm
SO test_artifacts/valid.xpm
WE test_artifacts/valid.xpm
EA test_artifacts/valid.xpm
F 127,151,223
C 11,207,105

11111111111111111111
1X0X	0000000000 0	01
1000000000 	00000X01
10X0	000000X0XX0 001
1000 XX00000X0000001
10	0 0000X00000000X1
100X00XX0000000 X	01
1	XN00000000 0000001
1000000000000 X00001
100X0000	000 0 0	001
1000 00000X00	000001
10000	 0X00000 00001
1 00 0X	000 00000001
100000 000 00XX00001
10 0X0000000000000 1
100000X000X000000001
1X000	000000 X0000 1
10000X00 X00X0X0 0X1
10000X0000 0000000X1
11111111111111111111
