NO test_artifacts/valid.xpm
SO test_artifacts/valid.xpm
WE test_artifacts/valid.xpm
EA test_artifacts/valid.xpm
F 101,,0,0
C 166,66,98

11111111111111111111
1 0	00000	0	0X000001
100000 00	 0000 0001
10000 0000000000	001
1	0X000X00 0 X0X0001
1000X0000000X00 0001
100	0 	0X000X0	X0001
10X0X000000X00000001
10		00X000000 000X01
10000X	 00	0	000  01
1X00X 00000XX00X0001
10 000000000X0000  1
10X000000X000X0X 0X1
10X00000000X000 0 N1
1000X0 00000000 0001
1	00	000 000X0 	0001
10000 0000000  00001
10000 0000000 00 001
1 000 00	0000000 001
11111111111111111111
