NO test_artifacts/valid.xpm
SO test_artifacts/valid.xpm
WE test_artifacts/valid.xpm
EA test_artifacts/valid.xpm
F 126,18,206
C 188,81,119

11111111111111111111
10000000000001000001
11000000000101100101
10000010001100101001
10100011001000001001
10000100000011001001
10000000000000000001
100000N0100000000001
10000000001100000011
10000000010000101001
11000000000110100001
10000000111010000011
10100100100000000001
10000000000000000001
10101000000100000001
10000001000010001101
10000000000000000011
10001010110101000001
10000100000010000101
11111111111111111111
