NO test_artifacts/valid.xpm
SO test_artifacts/valid.xpm
WE test_artifacts/valid.xpm
EA test_artifacts/valid.xpm
F 120,52,63
C 164,111,195

11111111111111111111
1 0000X0000	00 000	1
1000000000000000 X01
10000	00000000000001
100X00000 0XN0000001
1000000000000 000001
10 X0000X00 0 0  001
1  000000X  X00XX001
10X 000X0000X00000	1
10000X00000000000001
1000X00 00X 0000X 01
10000	00 0X 0X0	0001
1000XX 0	X	000000001
1000000X000X00X000 1
1000 X00000000000XX1
100000X000000000 001
10X0X000 0	X0	 00001
100 0XX000000	000001
100 00	00 0000 00	01
11111111111111111111
