NO test_artifacts/valid.xpm
SO test_artifacts/valid.xpm
WE test_artifacts/valid.xpm
EA test_artifacts/valid.xpm
F 223,,0,0
C 85,3,37

11111111111111111111
1000 X0000	000000001
100000X0X00	000 0001
10	0 0X000X0 0 00X01
10 00000X000X00 0001
10 0X0X000 	000000X1
10 00000000000XXX0 1
10000NX00X0000 	00X1
10	0X00	00X0000000X1
10000X00X00 X0000 01
1X0000	000 000 X 	01
100 000 000000X00 	1
1 0	00	00 000000	0X1
10 00X0000	000000	01
100000000000X00 0001
1000000 0 X000000 01
100XX00	0000X 0 00X1
1XX000XX00000 0	0001
10 	0 	00XX000000001
11111111111111111111
