NO test_artifacts/valid.xpm
SO test_artifacts/valid.xpm
WE test_artifacts/valid.xpm
EA test_artifacts/valid.xpm
F 117,0,0
C 231,200,47

11111111111111111111
1000000000000000X001
100 0000000000000001
1000000	00000X 00001
10	00000000000X00001
10000 00X 00000X0001
100000X0 0000X0 0001
10000000X00000000001
1000000000	00 000X01
1X0 0000X0 0 0X000 1
10000 0 X0 0	0000 01
1000000 0000 0	00X01
1000000	0 X	 000X 	1
1 00 00X000 000000 1
10000	00000	0	000001
1000 00 X0000X 0X001
100000000000X X00001
10 X000N	0X 	 00  01
10 0	0 X00X00	 0	001
11111111111111111111
