NO test_artifacts/valid.xpm
SO test_artifacts/valid.xpm
WE test_artifacts/valid.xpm
EA test_artifacts/valid.xpm
F 29,199,147
C 216,2,95

11111111111111111111
1 0	00000X00 00 0001
10000000X00 X0X00001
10000X 0 	0000000001
100	X0X	X0X 000X0001
1 0X00000000000	00X1
100XX0000000	 000001
1X000 0X 0X00 000	01
10000	0000 00000X001
10 0000	  0 00X00001
1000X0X 0000000X0001
100000000X0X0000  	1
1000	00XX0000 000 X1
1000000 000XN0X00001
10000 X   	0	0000001
100000   X0X000000 1
1X00000000000000 001
1000X00000X0	0  0001
10X	  X 0 00X0XX0001
11111111111111111111
