NO test_artifacts/valid.xpm
SO test_artifacts/valid.xpm
WE test_artifacts/valid.xpm
EA test_artifacts/valid.xpm
F 100,63,31
C 251,131,254

11111111111111111111
10X		 00	0000 X00001
10XX000000000X000X01
10000 00	00XX  00001
100000	X00000 	X 001
1000 000X X0 00  001
1 00000000	X00 0X001
10 	0 0000	000000001
10000	X0X00X0 000001
1000	00000	0000000 1
10  X00000000X0000	1
10000  00	 0	0X00001
1  000 000 00X 00001
100X0000X0000X000001
100 XX0000	0XX0 0 01
10X	0	00 000000 0001
10 00000000000000001
1XX00	0 X00	X0  	X01
1 000000000X00NX0001
11111111111111111111
