NO test_artifacts/valid.xpm
SO test_artifacts/valid.xpm
WE test_artifacts/valid.xpm
EA test_artifacts/valid.xpm
F 239,95,218
C 167,106,134

11111111111111111111
10000001100000001001
11110000001100001001
10000001000000100111
10000000100001000011
10N00000001100000001
10000000000000000011
10000000100000001011
11000000000111000001
11000001000011000011
10001011000001001011
10101000000001001001
10100101000000001001
11000100000000000001
10000110000010001001
11000000010000000001
10100000000001000001
10000000101000001001
10001000001001010001
11111111111111111111
