NO test_artifacts/valid.xpm
SO test_artifacts/valid.xpm
WE test_artifacts/valid.xpm
EA test_artifacts/valid.xpm
F 86,249,145
C 251,196,18

11111111111111111111
1	00  	X0000	0000 01
1	000X00 000000X0001
1X X000000000 00X001
10 000000000000000X1
1 000X 0000X00	00001
10 0	00 0	00 0000	 1
1X0X0XX0000000000N01
10 00X0000	 0000	0X1
10000000 0000XX X 01
1 0	00000XX0000 X001
10X 0000X000000XX 01
1X 0X00 00	000000001
10X00X0 X000XX  0001
1 0000000X0000000X 1
100 00X0 00000	X0001
1000 	000X000	00X001
1	0X00 0X00 00X00	01
1 00000	00 0000X0001
11111111111111111111
