NO test_artifacts/valid.xpm
SO test_artifacts/valid.xpm
WE test_artifacts/valid.xpm
EA test_artifacts/valid.xpm
F 56,211,129
C 118,187,173

11111111111111111111
100000X000 00	000001
100	000000	X00 000	1
1 00	00X 0X00X0XX 01
1000	 000 0000	0X001
1		0000 00000000X001
10000X00 00X000000 1
100 X	00X 	00 X0	001
1X00 X00000000X00X01
1 00	00X0X 0 000 001
1X0000000X00 0000001
10 0000 000000	00001
1X X0X00	00 00000001
1 0 0X00000000000X	1
10000 X0000	00000001
10 X0000X00000X0X001
1	0000N000 	0X00 001
1000X	0000 000 000 1
100		00 X0 	 	000001
11111111111111111111
