NO test_artifacts/valid.xpm
SO test_artifacts/valid.xpm
WE test_artifacts/valid.xpm
EA test_artifacts/valid.xpm
F 119,156,60
C 111,135,128

11111111111111111111
10000010000001101001
10110000010010100001
10000101000001110001
10100010000001000001
10000101000000000101
10000000000000001111
10000000010000100111
10000111100000110001
10011000000000000001
1000011000000N000001
10000000100000010001
10010000100011000001
10000000010000101011
11001000010000111001
10010010001000100001
10001010010000101101
11000010000000100101
10000000000000000101
11111111111111111111
