NO test_artifacts/valid.xpm
SO test_artifacts/valid.xpm
WE test_artifacts/valid.xpm
EA test_artifacts/valid.xpm
F 167,1,206
C 76,18,128

11111111111111111111
1X000000000000XX0001
10 00X000 0X00000001
10000 00000000 X0001
1000X0000000000 0001
1X 	00	0X00 00000001
1 0	00 000X00XX0X001
1	 X000000000  000 1
1000000X00 00X000001
100 000000000000X 01
1 0000000X00 0000	01
100X00 	000000 00001
100 00X00000	 00X001
1000000000	000	0	001
10	X00000X0000X00001
1 0X000 X00000 00001
100 000 0000 	00X001
10	00N 0 0000000 001
100	0 X00X0 X000 001
11111111111111111111
