NO test_artifacts/valid.xpm
SO test_artifacts/valid.xpm
WE test_artifacts/valid.xpm
EA test_artifacts/valid.xpm
F 71,191,42
C 181,5,60

11111111111111111111
10000000000010100011
10000101100000000001
11000000100000011001
10100001100100100101
10001000000001001011
10000000011000110001
11000100000000010001
10000000000000010101
10000000000101010101
11000100100000000101
11000000100100100001
10000000011100000101
10000000000000000001
110010100100N0000101
11000000100000100001
10000000001000101001
10000001000000000001
10110011000010001001
11111111111111111111
