NO test_artifacts/valid.xpm
SO test_artifacts/valid.xpm
WE test_artifacts/valid.xpm
EA test_artifacts/valid.xpm
F 293,0,0
C 151,210,199

11111111111111111111
10 0000	X000 0 00 01
100X0000	000000X0001
10X00000000000X00001
1	000XX	0X000 0X0001
100 00	000000000X001
1	0000X0000X000	0001
100  000000	00000X01
100000000000X00 0 01
10000X	X0000000000	1
1	00000	0X00 0X00X01
10X00000 00000000001
1 00000	X00000 0 001
1000 0000 0000		0001
100 0	0	000N00	0 0 1
1000000000000000X001
10000000X	 000 00001
1X0 00 0	00000000001
100	 0 0000000X00001
11111111111111111111
