NO test_artifacts/valid.xpm
SO test_artifacts/valid.xpm
WE test_artifacts/valid.xpm
EA test_artifacts/valid.xpm
F 16,190,202
C 160,72,65

11111111111111111111
1 X0000000X 0X X0001
10X00X00 X 00  00001
100	 00 0 00X000 X01
1 0000X000000000 001
10000 0000 00 X0 001
100 000000000XXX	001
1000000	000 000000 1
1X0 000X00 0 0 00001
1000000000 000000X01
1000X00000000	00	0	1
10000 000000 0000001
100000  000  000 001
1000  0 	00000000001
1	00N 000000 0 0X001
10000XXX000X	0X 0001
10000000 000X0 X0001
1XX 00000000 0000 01
1000 0000000000	0001
11111111111111111111
