NO test_artifacts/valid.xpm
SO test_artifacts/valid.xpm
WE test_artifacts/valid.xpm
EA test_artifacts/valid.xpm
F 122,0,0
C 0,253,48

11111111111111111111
100 0000	0000000		01
1 	00 	0000000 000	1
10000000X000 X 0X 01
1 0000 0000000000001
10 00	000000XX000001
10X00000000	00000001
100 	00 X0 000 00001
100 X0000  0 0000	01
1 0000000000X0 00001
10000	0X00000	000001
1000000 000X00X00001
10	0000000	0000X0X01
1000X X000 000X0 001
100000000	 00000X001
100X X 00000X0X00001
1 00N 0000000 X000X1
10000 0X0X	000000 01
10X 00000000000 0001
11111111111111111111
