NO test_artifacts/valid.xpm
SO test_artifacts/valid.xpm
WE test_artifacts/valid.xpm
EA test_artifacts/valid.xpm
F 63,190,116
C 128,136,38

11111111111111111111
10X00000 0	0 00 X001
1000X 0000 0000X0X01
10	 0X00000000 00X	1
100 00000X0 00	00X01
1X000 X0	0000 	00001
1000	000 0	00	000001
100000000000 0000 01
100 000000  000000X1
1000X0 0X0	 X	000 01
1 00000000	0 0 X0001
1000X00 000000000001
1X00000 00000 000001
1 0000X0000000000001
100	00 N00	000000001
1 00000000000X0000 1
1X0X00000	000 		 001
10   00	X000 0X	00X1
100000X0X00	0 000X01
11111111111111111111
