NO test_artifacts/valid.xpm
SO test_artifacts/valid.xpm
WE test_artifacts/valid.xpm
EA test_artifacts/valid.xpm
F 155,253,80
C 213,231,219

11111111111111111111
10000000	0 000000 01
10000	0000X0000X0X 1
100X000000000000  01
100000XX00 00XX00001
1 0	0000 00 00000001
100X000000   	000X01
100  X00 00X00 00  1
1X00 000  00XX0  X01
100000 00000X000X001
10	0X00  0000000  01
1N0000000000 000 0 1
1000000000	0  0000	1
10X0000 0	0000000001
10X0 0000X0000000 01
1	000 0000000000 001
100 0	000 0000 0 001
1000000 0 00  000	01
1X000000X00000X0X 	1
11111111111111111111
