NO test_artifacts/valid.xpm
SO test_artifacts/valid.xpm
WE test_artifacts/valid.xpm
EA test_artifacts/valid.xpm
F 63,226,176
C 125,134,68

11111111111111111111
10000010100100000011
11100000000000011001
10011000001001001001
11010000010001000011
10000000010000010111
10001000000010000111
10000001001100101011
11010010000010000001
10000010111010000001
10000000000000000001
10000N00000110000101
10000000000000100101
10001100001000100001
10001110100011000011
10000000000100111001
10000010000010001001
10100011011001000001
10001000001000000001
11111111111111111111
