NO test_artifacts/valid.xpm
SO test_artifacts/valid.xpm
WE test_artifacts/valid.xpm
EA test_artifacts/valid.xpm
F 11,238,255
C 27,205,82

11111111111111111111
10000000100000000011
10010N01000000010001
10010001000000001101
10110110001001000001
10001000000010000111
10110100000000000001
10010010001000010011
10101010100101010001
11000010010000000001
10010000001000000111
11010000000000000001
10010000000010000101
10001100001011000101
10000001000000000001
10000001011000000101
10000100010010001011
10010110110000010001
10000000000000000001
11111111111111111111
