NO test_artifacts/valid.xpm
SO test_artifacts/valid.xpm
WE test_artifacts/valid.xpm
EA test_artifacts/valid.xpm
F 172,5,229
C 192,249,185

11111111111111111111
10000X00 0	0N0000001
100X00 X000000	000	1
1X00000	0000X 0XX001
100000X000 000000001
10000	0 000	X 0000 1
100 00000X0 	0000 01
10000000 0000X00XX01
1000000X X 000000  1
100X0 00 00 000000	1
10000000 0000000 	01
1X000000000000 00001
1 0000000 00000 0001
10000000000000000X01
100X0000X000X0000001
1000000 000X0X 00001
1X0 0  000000	X00001
1X00000000	000000001
1		0X00X00 0000X0001
11111111111111111111
