NO test_artifacts/valid.xpm
SO test_artifacts/valid.xpm
WE test_artifacts/valid.xpm
EA test_artifacts/valid.xpm
F 43,12,229
C 68,238,121

11111111111111111111
10000000000000	 0001
10000000000000X 0X01
100X00000000	000X0 1
1000 0	000000000  01
100	0  0000000000001
1000X00000X0000000 1
100 0000000X0 000XX1
10 0000X00 0	0X000X1
10000 0	000 0 000	N1
10 0X00X000X00000X01
10	00000 00X 0 00001
100XX0X0 0 00  00001
1  00 X00000X00	X0X1
1X0 	00X0000000000X1
1 000000000000X00001
1000 0	00 	 00000001
100 XX0000000	0X0X01
1X 000000000 000 001
11111111111111111111
