NO test_artifacts/valid.xpm
SO test_artifacts/valid.xpm
WE test_artifacts/valid.xpm
EA test_artifacts/valid.xpm
F 67,210,71
C 59,153,243

11111111111111111111
1X 0X0000000 0000001
10000 0000	X	0000001
100000X0XX0 XX00X 01
100000000 00000X0001
1000000000 000000001
1	0000X00 00000000 1
10000000 0000N0 0001
1000 0  00X0X	 00X	1
10X	X00 00	000000001
10X0	0	00 0000 X0001
100000000 	000000X01
1000X000 0X00X 0XX01
1X00X000X000 0X00001
10 000	00 X000000001
10000000	000XX0XX0X1
10000000000000X00001
1000000  0000X0X0001
100 0000 000 0000001
11111111111111111111
