NO test_artifacts/valid.xpm
SO test_artifacts/valid.xpm
WE test_artifacts/valid.xpm
EA test_artifacts/valid.xpm
F 200,0,0
C 83,55,124

11111111111111111111
1000 0000000000 0 01
10000000X	0000X00001
1 0000000000X00	X001
1000000 0000000000 1
1 	0XX 00	0000000001
1000X000X00X00 000X1
10 00000X000X0000001
1 0 0 000X000000	001
1000 00	X 0000	XX001
10	000	000 000000001
10 00000000	0 0000X1
1000000X000X 0000001
1X0000000X	XN X00001
1000000X0X 000 0	 X1
10000X0000	X0000X001
100000X00 000000X001
10000000 0X0X00XX001
100X 0000X000 0000 1
11111111111111111111
