NO test_artifacts/valid.xpm
SO test_artifacts/valid.xpm
WE test_artifacts/valid.xpm
EA test_artifacts/valid.xpm
F 71,112,23
C 129,68,164

11111111111111111111
100000 0X00X0000 001
1X00 000	 00X0 0	001
1X X000X0000000000X1
10000 	0000	X0000001
10X00000000000XX0N01
100000	000X00	 000	1
100 00000000	X  	0 1
1XX000000000 00000 1
1000 00000X00X00 0 1
100X00 0  X0000X0X 1
10 XXX00000X00	000	1
100000	  0 000000001
1 000 000XX0	000	001
10X000000X0000X0X0X1
100000000X0000000001
1	0	 000X0X00000	001
10	X0000X 0  00000	1
1000X00000	0000 X001
11111111111111111111
