NO test_artifacts/valid.xpm
SO test_artifacts/valid.xpm
WE test_artifacts/valid.xpm
EA test_artifacts/valid.xpm
F 123,0,0
C 66,224,170

11111111111111111111
100 00000000X0000001
100000 0000000000 01
100000000 X00	0000 1
10 00000000000000001
1X00000000000	   X01
1000 00	 	0000000001
10 0X00X00X	X0000X01
100X000 000000		   1
100000X00X00000		001
1	0000 00000000000 1
10X000000X000N00X0X1
10000000000X00000001
100X0000000000X00001
1000  00X000	0X 0001
100X00X0X00000000001
1 00000000000000X0 1
1X00X000000000 00001
10000 0X0   000000X1
11111111111111111111
