NO test_artifacts/valid.xpm
SO test_artifacts/valid.xpm
WE test_artifacts/valid.xpm
EA test_artifacts/valid.xpm
F 100,,0,0
C 107,29,239

11111111111111111111
100000X0000	00000 01
1000 000000X000000X1
10000000 X	00 00X001
10 00000000000000001
100X0N0X0000 X00X001
100	0000000000000001
100000X000000X0000 1
1000 00000 000 000X1
10	0 00000	 0 XX 001
1X0000000000 0 0X0X1
1 X00 0 0X00X0X00001
100000 0000X0X0	00 1
100X	 0	000000000001
1000000 0X X00 00001
1	 	00000000000X0001
100 000 	X X00000001
1X000 000000000  	01
10000 00000000000001
11111111111111111111
