NO test_artifacts/valid.xpm
SO test_artifacts/valid.xpm
WE test_artifacts/valid.xpm
EA test_artifacts/valid.xpm
F 46,0,0
C 3,124,44

11111111111111111111
10000000X0000000 0 1
1 000000X00 X000X001
100000000000X0000001
10XN00000000  X00001
10	0000 0000 XX 0001
10 00 00X XX0  XX001
1	000X000 	00		000	1
100000X0000X00000001
1000000X000	0000	001
10	XX	0X 00 0000 001
100X 0 000000X0X0001
1000XX 0000X	0000001
1000	 00 00000000	01
1000 0	X000000000X01
10000000	0000 0XX0 1
1X0X000		0000000 0	1
100		0000X X00000001
1X00X0	0 00000 X00X1
11111111111111111111
