NO test_artifacts/valid.xpm
SO test_artifacts/valid.xpm
WE test_artifacts/valid.xpm
EA test_artifacts/valid.xpm
F 199,43,49
C 154,13,126

11111111111111111111
10X000000000X00 0 01
10X X	X000000 0X0X01
100 000000X0X		 00X1
1X	00	XX00 0N000 001
10X 00000000000000X1
10X X000000X0000 X01
10	0X00000 000000001
100000 0  0	00000XX1
1X00	000000 000000X1
10X0000000X0 0000 01
100X000000000X00	001
10000000X0	0	0000001
100000X00X0 00000 01
100	00 00000  000001
1000000 0X0000000001
10X000000000X X 0001
1000X00000000	0 0001
10X 000X0 	 00 000X1
11111111111111111111
