NO test_artifacts/valid.xpm
SO test_artifacts/valid.xpm
WE test_artifacts/valid.xpm
EA test_artifacts/valid.xpm
F 203,0,0
C 166,55,185

11111111111111111111
1	000X0000000000 001
100 0000 000	0000001
1X0X00000X0X 00	00X1
1000000X00000000 X 1
10 0 000		00 0000	X1
10000X XXX0X0X00	001
100000	00X000 0X0001
10000000000000000  1
100X0000	0	 00000001
1000000 	00	00000X01
1X0000X00 X0	0000001
10  00X00000N00X0001
10	000X000 0	 00X 01
10X0000000 000000001
1000000 00X0	000X	01
1 00000 X 0000 00001
10X000 0000X0	000001
1000000	000000 X0	01
11111111111111111111
