NO test_artifacts/valid.xpm
SO test_artifacts/valid.xpm
WE test_artifacts/valid.xpm
EA test_artifacts/valid.xpm
F 209,,0,0
C 28,175,118

11111111111111111111
100 0	0	000 0 0X   1
10XX0	X 0	0 0X000001
1000	000	00X00	00001
100000000  0000XX0X1
10000000X 000X00X001
1 0X0000000 00X000X1
10 000000X0000 00001
10	000	0000000 X0001
1	00		000000000000 1
10 0000X000000   001
10000000 000 0000001
10000000 0000 00	X01
10000000	0 000000 X1
10000X000000000X0  1
100X		X000	00000	001
10	00000000000000N01
10X 0000 00000000	01
1000000	 0 00X0X X01
11111111111111111111
