NO test_artifacts/valid.xpm
SO test_artifacts/valid.xpm
WE test_artifacts/valid.xpm
EA test_artifacts/valid.xpm
F 33,53,27
C 87,215,179

11111111111111111111
10 00 000X00X00000	1
1000000000 0000	00X1
10	  000X000X0000001
1000 000000000000001
100X0000X00X0 00X0 1
1000  0000000 	00X01
10000 00000X	0000 01
100X0000X00  0	00	01
100000X00000000X0X01
100000000	N000	000 1
10000	X00000 0000001
100000	0X00000000001
10 0000	 000	X000 01
100 00000 0000000001
10 	0000 XX000000001
100000X0	000	00 0001
10 00	000000000 0001
1000	00000000	0000	1
11111111111111111111
