NO test_artifacts/valid.xpm
SO test_artifacts/valid.xpm
WE test_artifacts/valid.xpm
EA test_artifacts/valid.xpm
F 142,47,151
C 19,165,243

11111111111111111111
10001000000111000001
10000000110000100011
11100001000100010001
10000010001000000001
10000110000010000101
10N00000000000010111
10001000100000000101
10001000000000010011
10000100000001100001
10010010001000000101
11001000000100001001
11010000100010001001
10001000100100000001
10100010010100001001
10000000000010100001
10010000000110101001
11001000001001100101
10001000000101000011
11111111111111111111
