NO test_artifacts/valid.xpm
SO test_artifacts/valid.xpm
WE test_artifacts/valid.xpm
EA test_artifacts/valid.xpm
F 36,,0,0
C 206,179,42

11111111111111111111
10000	000  00X0000 1
10 00000000000000001
100		0 0000000000001
1		0X0 X00000X0 X0 1
10	 0000X00000000001
1 X 00 0000 000000X1
100 0 00000000000001
1	0000000 0000000001
100000000X0X 0000001
100X00000 0XN 0X 0	1
100000	00000XX0000X1
10	00 00 00000000001
1 00XX00 000X0000001
100000X00 X000	0X001
100000000X0000000001
1000 0X000	 000 0001
100000000X0000X 00X1
10 00000000	00000X	1
11111111111111111111
