NO test_artifacts/valid.xpm
SO test_artifacts/valid.xpm
WE test_artifacts/valid.xpm
EA test_artifacts/valid.xpm
F 137,166,28
C 22,8,86

11111111111111111111
10001000000000011011
11000000100100000101
1000N000000000000001
10000000010100000001
10000100000000000101
10001000010000000001
10000000110000000011
10101000100000010001
10010000001001100101
10001010010010100101
10000000101000111101
10111010000000000001
11001011000010010011
11100011011000000001
10010000001000000001
10111000001100001011
10000010000000000001
10000000000110000001
11111111111111111111
