NO test_artifacts/valid.xpm
SO test_artifacts/valid.xpm
WE test_artifacts/valid.xpm
EA test_artifacts/valid.xpm
F 2,168,54
C 41,116,135

11111111111111111111
1 0000000X 0	00 0001
100 00000000000 0 	1
1	0000000000000 0001
100X00000000  000001
10000 X0X	  00	00 01
10	0000X00000XX00001
1  0X00000X0	0000001
10 00000	 0000000001
10  00000000 00000 1
1000X00NXX0 0 00XX01
10000 00	00 0 00 001
1	 00 0 	0 000000001
10X00XX00000 0X00001
10000000	0X000000X 1
1X 00000000000000001
1000 000	0	0000000 1
1X 00 000000	00 0001
1000000	000	 00X 001
11111111111111111111
