NO test_artifacts/valid.xpm
SO test_artifacts/valid.xpm
WE test_artifacts/valid.xpm
EA test_artifacts/valid.xpm
F 213,153,199
C 199,31,162

11111111111111111111
11100000111000000001
10010100010001100001
10000000000010100001
10000001000000010011
10000001000000000001
10010100000100000001
10100011000000000001
10100011000000000001
1000000101000100N001
11100001110000000001
10100000000100010001
10001000100000010001
10000100000000001001
10001000001111000001
11100000010000100001
10001001000000000101
10001000100001000001
10001100000010010001
11111111111111111111
