NO test_artifacts/valid.xpm
SO test_artifacts/valid.xpm
WE test_artifacts/valid.xpm
EA test_artifacts/valid.xpm
F 147,218,250
C 219,62,131

11111111111111111111
1000 0000000X00000	1
1  XXX000X		 0000001
100	00 X0000  000001
10 000 00X0000000001
1	N0000X000X000X 001
100000X00 0000000XX1
1			000X000000000 01
1000	000	000000 X001
1000000  000 0X00001
100XX		00 00 0XX 0 1
1000	XX0000X0000	001
10000	000X00		0000	1
10000 00000000X00X01
1000XXX0000000000001
1X0 00	0000X 0X0 0 1
1 X00X0000	00 00X001
100000X	  000 000001
1X0 0000 000X 000	01
11111111111111111111
