NO test_artifacts/valid.xpm
SO test_artifacts/valid.xpm
WE test_artifacts/valid.xpm
EA test_artifacts/valid.xpm
F 243,96,128
C 57,60,97

11111111111111111111
1000X0000000000 0001
1X000	X000X X0000001
10X0	00X0000000000X1
1000	 0X000000000001
10X0000X0XX000 00 01
1000000000000000 001
10X0000	0 0X  0 0001
10000000000000000001
10000 0 00X000X0 001
1 0000		 	00X0 000	1
100000X000 	000	0001
1000 000000X0000N 01
1000000000X00000XX01
1000 0 000 000000001
1 0000000	00  000001
10000	0000X	X000X0	1
100000000000	 000001
10X	0	0	X00000000001
11111111111111111111
