NO test_artifacts/valid.xpm
SO test_artifacts/valid.xpm
WE test_artifacts/valid.xpm
EA test_artifacts/valid.xpm
F 64,171,225
C 228,57,221

11111111111111111111
100X 		 	X00000	0001
1 0 000000000X00X0	1
1000000 00 00   	001
1	0 0000000X0 000001
10X	000000	0XX  0 01
100000 00N0X0000X001
1000X000	 00 0000001
1X  0000000000000001
1X000000	0000X000001
1 0 	000000000 000X1
10000 00 0X00000	0X1
10000000  0000000X01
10000000000X0   	X01
1000  0X00X000000001
10000	0000XX0X00 X 1
10000000000000000001
1000000X0000	0000001
1X00	000X000XX0000X1
11111111111111111111
