NO test_artifacts/valid.xpm
SO test_artifacts/valid.xpm
WE test_artifacts/valid.xpm
EA test_artifacts/valid.xpm
F 197,217,90
C 227,27,251

11111111111111111111
10X000X	X0 00 0 0001
1 00000000X00000		01
1  00000 0000 00 001
10000X00X0X00  00001
1	000000000 00	0   1
1000	000000000000 01
1	 00 0X0X0N000X0001
100000 000 000 000 1
100	X00000 0X000		01
10000X0	 	0	000XX001
1000 00	0  00XX00001
100000000X0000000	01
1000000000000000 0 1
10 0000X00000000X001
1X00000	000	X000X001
1 00000 00000X0	0001
1X0 000X00000 00 001
100X0000000 00000001
11111111111111111111
