NO test_artifacts/valid.xpm
SO test_artifacts/valid.xpm
WE test_artifacts/valid.xpm
EA test_artifacts/valid.xpm
F 228,,0,0
C 230,171,14

11111111111111111111
1000X000X00   X0 001
1000	0N000 X00000001
1000X000000000000X01
1 0000X0000 000000	1
1000	000XX00  0X0001
10 00000000X0 0	0	X1
1X00X0	 00 000000001
10X0 0000 0	00000001
1000 00 00 00 0   01
1X0 00000 00 0X00001
1000 0000X0000000001
10X000	X0000000000 1
10 0	00XX0000X00 001
10	0000X0 0 00000001
10000X0	0X	0X0000001
100X 0000000XX00X001
1	X00X00000000X0  01
10 0000000X00 000001
11111111111111111111
