NO test_artifacts/valid.xpm
SO test_artifacts/valid.xpm
WE test_artifacts/valid.xpm
EA test_artifacts/valid.xpm
F 66,0,0
C 224,38,205

11111111111111111111
1 0	0X000X00	0	00001
10000 0000 000X00001
10X	0X0000000X000001
1 0X00000 000	X00001
1000 000 00X00XX00 1
10 0  0 0X00 0000001
1	0000X00XX0000XX001
1X0  0000000	0000001
10X00X0X000 0X000001
100000000X00000X	0X1
100000 XN00000000001
1000 000X0X000 0X001
10000	00XX0000X00	01
1000X000000X	00X0001
100000000 000	000 01
10000000000X00X0X 01
1XX00	0X000000000X01
10000000000  0000001
11111111111111111111
