NO test_artifacts/valid.xpm
SO test_artifacts/valid.xpm
WE test_artifacts/valid.xpm
EA test_artifacts/valid.xpm
F 26,,0,0
C 54,133,249

11111111111111111111
10000000	00	00000001
10X00 X00000X0000001
10 0 00 X0	0000 0001
1X0000 00N000XX00001
10X000000	000000X 01
1 0000 000 000000001
10000000 000 X0 0X01
1000 00X000X00	   01
10000 000000X 000001
100000X00000XX00 001
1X0X00X000000000	001
1000000000 00000X001
10000000000000000001
10X0000 00000XXX0001
10X0X  000	0000000X1
1000000 0 0000000X 1
1	00 X0	00	0000 0  1
10000XX00000  00X0 1
11111111111111111111
