NO test_artifacts/valid.xpm
SO test_artifacts/valid.xpm
WE test_artifacts/valid.xpm
EA test_artifacts/valid.xpm
F 199,240,95
C 233,184,75

11111111111111111111
1000000 0000X0X00001
1000  0 000000000001
100 0 0X 00 00000001
100000000	0000000001
10 X0 0 	X0 X0000X01
100	00000 0X0000X001
1 	0	00000	000000001
10000000 0XX00X00001
1	000X0 0 0X00000001
1XX0	000000000000	01
1000XX0 00N0000	00X1
100000000 000 000001
10000X0000000 00 0 1
1000000X 0000X0000 1
10000000 000000	0001
1 0000000XX XX00X001
1  000X0X00	XX0X00X1
100X00X00	00XX 00001
11111111111111111111
