NO test_artifacts/valid.xpm
SO test_artifacts/valid.xpm
WE test_artifacts/valid.xpm
EA test_artifacts/valid.xpm
F 102,54,28
C 100,7,10

11111111111111111111
11000100100100000011
11000000010000000111
1000N000000000001001
10000000001000000001
10000011000000001001
10010001000011000001
11100000000101000001
10000100000100000001
11110000000000001011
10110000000000000011
10100001000000000001
10000000001000000001
10000000010000000001
11000000010110100001
10000010000011010001
11000010010010000001
10001000000100001001
10010000001100000001
11111111111111111111
