NO test_artifacts/valid.xpm
SO test_artifacts/valid.xpm
WE test_artifacts/valid.xpm
EA test_artifacts/valid.xpm
F 200,117,254
C 205,131,41

11111111111111111111
1 00		0 0 0000000	01
10	0 000 000000	00	1
1000X00000 00 00X001
1000000 0X000 0 0001
10000	00X000	00000 1
1 0	0000X0 0000X00X1
1000X000000000000001
100 000000000 000001
100X0X000000000XX0N1
1000000 0X0000 00001
10000 000	0000X00001
1000X0  0	0X00000001
100000 00000 000XX01
1X000000000X00000001
1X0000	000 0 000X001
1000 00X00X000 X0001
1000000000000	0X00 1
1000 000X0	000000001
11111111111111111111
