NO test_artifacts/valid.xpm
SO test_artifacts/valid.xpm
WE test_artifacts/valid.xpm
EA test_artifacts/valid.xpm
F 171,113,19
C 71,111,92

11111111111111111111
1	0X000000X000000 01
1	 00X0X00 00X0000X1
1XX 000000 00000X0X1
1 X 00000X0 00000001
10 000X	0000 0000001
10X000X  	000000 0 1
100000 0000000000001
1000X0	0000000000	01
100	X0000NXX0 0  XX1
10  0	00	 0 000XX001
1X0000X	000 000 0001
1 000X000	00  000 01
100000 00 	00000 X01
10X000 00X00000X0001
100000	000000000 0	1
100 0 0000  0000		01
100 000X0	000000	001
10000000 000000X0	01
11111111111111111111
