NO test_artifacts/valid.xpm
SO test_artifacts/valid.xpm
WE test_artifacts/valid.xpm
EA test_artifacts/valid.xpm
F 292,0,0
C 29,170,50

11111111111111111111
1	000000X	 0000 0X01
1X00X000  00X00000 1
1 	000 0 000X000 001
10   0000000 0000 01
1000X0000X0000000001
10 	0 0	X00000 0 0 1
10 	 0 0	00000 000X1
10000000XX0 0000X 01
10000000	 0000000N01
100000000X0 	0000001
100	0  X000 0X00	001
1000X0000 00 0000001
1 0 00000X0000000	01
10	00X0 000000X00001
100	0X0000X0000	0001
10X00000X000 0 00001
1000X00000 00000 001
1000000000   00000X1
11111111111111111111
