NO test_artifacts/valid.xpm
SO test_artifacts/valid.xpm
WE test_artifacts/valid.xpm
EA test_artifacts/valid.xpm
F 192,185,145
C 205,165,90

11111111111111111111
1	000  X0000000	0001
10000X0	000000000001
1	X0 00	X00000 00001
1000X0000000000X0001
100X00	0 000000 XX01
1 000000000X00000001
1 00000X	000 0000X01
10000	0000X00X000 01
100000X00X0 000 0001
10	000X0	   00  0001
10000 000X0X00000001
1	X0000 0000	00000 1
1000X	0000000 000001
100000 X0	  00  0001
10	0X00  0000X0X00X1
100X000X000 00N00001
100		0000X00000X0001
10000X	000000000X001
11111111111111111111
