NO test_artifacts/valid.xpm
SO test_artifacts/valid.xpm
WE test_artifacts/valid.xpm
EA test_artifacts/valid.xpm
F 150,164,114
C 31,26,238

11111111111111111111
10000000010010010101
11000011000100000001
10000000000101111001
10010000000000000011
10000010001000000001
10010011100010010101
11010000011001010101
10000000100000010001
11100000000100000001
10000000000001100101
11001111011010011001
11110001000010000001
10001001010110100001
10000000011000000001
10000000000000000001
10001100010000010001
10000000000N00100101
10000000000000100001
11111111111111111111
