NO test_artifacts/valid.xpm
SO test_artifacts/valid.xpm
WE test_artifacts/valid.xpm
EA test_artifacts/valid.xpm
F 23,203,177
C 155,40,174

11111111111111111111
1		0X0X0X000000X0001
1X000 0X000X00	00001
1 0000	0000000000 01
1 000000X00X00X X001
1 000  0	00X00000001
10XX0000X0000000X001
100 000   0000	0 001
10X 0000 000	 00X001
1X00000 000 00000X01
100X000000N0	000X001
1 00000 0000 000X	 1
10000X00X000000000	1
10X 00000	0 0XXX0001
1 000000 00000000X01
1000X00 000	0	00X0X1
1000X0000000X000 001
1	0 0	0000 00 000XX1
1 X0	000000 000000X1
11111111111111111111
