NO test_artifacts/valid.xpm
SO test_artifacts/valid.xpm
WE test_artifacts/valid.xpm
EA test_artifacts/valid.xpm
F 225,0,0
C 159,130,90

11111111111111111111
10X000  000000000001
100 000X0 0000X0X0 1
1 0XX0000X0X000X 001
100000000000000000 1
100X  X00	000 0 0001
10X000000000X0X0X001
1 00X0X00X0	00000 01
10		0000000X00N00001
100X0 000 		00000001
1000X0000 X0 	000XX1
10000000000000 00	01
100000X0000 	0 00001
10 00000000000X000	1
10000X0000 000X00	01
100X000X00 X0X000	X1
100000000X0X00000001
1 00X000XX	X00000001
1000	X0 00000X00 001
11111111111111111111
