NO test_artifacts/valid.xpm
SO test_artifacts/valid.xpm
WE test_artifacts/valid.xpm
EA test_artifacts/valid.xpm
F 139,33,231
C 13,51,217

11111111111111111111
10000000X 0X 0	0	001
1000000000000 000	01
100000 X00X0X00000	1
1000	X000	 0	 00X001
100000XX000000000001
1000000000X0X	000001
1000000X00 X00000001
10	0000000000  00001
1000000 0X0000X00X01
1000	0000X000  00001
100XX0000	X 00000001
100000N 000000 00001
100	00000000	0 00 01
1XX00	0X00 0000000	1
1000000000000X000001
10X00	0 00000X000001
1X0X0 00X000 0  00 1
100X000000	0000000 1
11111111111111111111
