NO test_artifacts/valid.xpm
SO test_artifacts/valid.xpm
WE test_artifacts/valid.xpm
EA test_artifacts/valid.xpm
F 247,253,39
C 181,16,44

11111111111111111111
100	N0X00	000000X0 1
10000000 000X0000001
1000X000X		0000000X1
100 000	000 	0000001
1X0000000 0	000	0 01
1	0 0X000X0000X00001
1000X0	 0 00000 X 01
1000 000X000000 0001
1XX000X0000000000001
1X00X0000000 0000001
100 00000XX0X00  	01
1000000X00X00000	001
100000 00000000X0001
1000 00XX00000000001
10  	00X00 0000 00 1
1X000X00 00	0000X001
1X0000000 	00X000X 1
100X0000XX00000	 	01
11111111111111111111
