NO test_artifacts/valid.xpm
SO test_artifacts/valid.xpm
WE test_artifacts/valid.xpm
EA test_artifacts/valid.xpm
F 60,241,248
C 3,154,40

11111111111111111111
1X000000	0000000X001
1X000000000000000001
1000 		 0X 0 0X000 1
100000000X0N	0 000X1
10X00000XXX0X0X0 001
10XX00000000	00000	1
10 0 X00000000X	 001
1	000000  00 0 0 0 1
10000000 0	000000001
1000000000 	0000 001
10000000000X00000001
10	0 00000X000X00X01
1 0 00000X0000000001
100 X	0000   0000X01
1	0000 00000000000	1
1 000000000 0000 0X1
10X00 0 0 X0	000 0	1
10	0000 0000 	0000X1
11111111111111111111
