NO test_artifacts/valid.xpm
SO test_artifacts/valid.xpm
WE test_artifacts/valid.xpm
EA test_artifacts/valid.xpm
F 102,132,242
C 19,10,20

11111111111111111111
10	00X0 00 X0	 00001
10000 00X000000000 1
1 000000000000000001
100 0	0 00X	 00000 1
1000000X000X0 0000X1
1000000	0000000 0001
1 00 	00000000000XN1
1000 X000000X0 00 01
10000 X0 X00000000X1
1000000X000 000000X1
100X000000000 000	01
1000X 	 00X000000001
1 00000X000 00000001
1000000X0X X00000001
1  0XX00000000	00X 1
10000000000000000001
1000000000000 000  1
100000000000	00X0001
11111111111111111111
