NO test_artifacts/valid.xpm
SO test_artifacts/valid.xpm
WE test_artifacts/valid.xpm
EA test_artifacts/valid.xpm
F 175,0,0
C 198,208,13

11111111111111111111
10000000 00 X 0 0001
1 0	0000000   000001
1X0N00000  00000 001
10 XXX00 00X00X0 001
1X0X0000X0000000X001
1	XX	000000000000 X1
10X000000000000X00 1
100	000X00X00X000		1
10000000	000X0000001
10	000X0 000	X00  01
100 00X0000000000	01
1X0000000X0 0000 X01
10X000 X	0	0	0000001
10X00X00	00X000X  01
100 0	000X0 00000001
1	000 0000000X0 0001
1X00  0000000X 00X01
10000 0 00X0 0000001
11111111111111111111
