NO test_artifacts/valid.xpm
SO test_artifacts/valid.xpm
WE test_artifacts/valid.xpm
EA test_artifacts/valid.xpm
F 189,27,26
C 44,190,155

11111111111111111111
100 00000000 00X0001
10000  000 0	0000001
1N0X0000 X0000000X01
10000X000  000000001
100000000X00000000 1
100XX0000X0000000001
1000	000X000	0X00001
1	00000X00  0  0X001
1000 0000000 00	 001
1 000X00 00X	0000 01
100000X00000 000  01
1000000 00 0X0X00001
10000X00000000000001
100000000	XX00000001
10000000 0000	000001
10000X00000X00000001
100000000 0000000X01
1000000000000XX0 001
11111111111111111111
