NO test_artifacts/valid.xpm
SO test_artifacts/valid.xpm
WE test_artifacts/valid.xpm
EA test_artifacts/valid.xpm
F 110,96,180
C 176,89,219

11111111111111111111
10000000 	00  00	0 1
10000 0000000 000001
100000X000000000XX01
100000000X0000X00001
10	000000	0 000000	1
100000 0X00X00000	X1
10 00 000000000 0001
100000000 X000000001
1X000X00 000 0000X01
1 000000000 00XX0001
1	0X0 0000000	00	0 1
1X 	000X00	000000001
10000	00000X000	0 01
100000	  000000000 1
10	N0X0000000X000001
1X000X00000X000 00 1
1000 00000 0000 00X1
10000XX X0	000X00001
11111111111111111111
