NO test_artifacts/valid.xpm
SO test_artifacts/valid.xpm
WE test_artifacts/valid.xpm
EA test_artifacts/valid.xpm
F 254,254,244
C 26,56,38

11111111111111111111
100000000	0X0 00 001
10	0 000	0000XX0X001
1000000 X0000 0	0X01
1000000X000000000	01
10 	000 000X00X0	0X1
10000000N00000000001
10000X0	00000 000001
1X0000  0000X0X00 01
100 00X0 0X000000001
1XX00000 00000000001
100	000000  X0X00001
1 00000000 0000 0X 1
1X0 0000000X00	00001
10X0X000X0	0	0	 00 1
10 00000000000  X001
100 0	0X00X0	00 0001
1X	000000X00 0	000 1
1	00 0X0	X00000 00	1
11111111111111111111
