NO test_artifacts/valid.xpm
SO test_artifacts/valid.xpm
WE test_artifacts/valid.xpm
EA test_artifacts/valid.xpm
F 9,68,2
C 79,147,149

11111111111111111111
11100000000000000001
100000000N0000001001
10001000000101011011
10001110000011111101
11000000010000100011
10000000101000000001
10010001000010100001
11110001000000000111
10010000001000001011
10000110000100000101
10000000000000000001
10000000100000010001
10000010010001000101
10000010000000000001
10011000000000001001
10000010001010001001
11110000000000000111
10001001100000000001
11111111111111111111
