NO test_artifacts/valid.xpm
SO test_artifacts/valid.xpm
WE test_artifacts/valid.xpm
EA test_artifacts/valid.xpm
F 97,226,67
C 38,126,48

11111111111111111111
100XX000X  000X00X01
100X		0	00000000	001
100	000000000000	001
1000000000000X0 0001
100 000000000000X 01
100X0 0000000000	001
1000000X 00X 0000001
100	00000	00 0X00001
1 00	0  000 00 00	01
1000X	0000	0 0		0001
1X	 000000X0		0X00X1
1000000000000X0X00 1
1 000000  00 X0000	1
10000 0X0	00  X0 0 1
1000X0 0000000000	01
100XX0N0X0000X0	0X 1
10X 000000X000000001
100 000 X00000X00X01
11111111111111111111
