NO test_artifacts/valid.xpm
SO test_artifacts/valid.xpm
WE test_artifacts/valid.xpm
EA test_artifacts/valid.xpm
F 30,119,186
C 222,225,167

11111111111111111111
100 00000 00 X 0X0X1
100000 0000000000001
100X 000XX0X0X 00001
1000 00  0000 000001
100000000  0000 0 01
1X000000X00000 0 001
1XX0 00	X00X 0000X01
1	000	0000X000000001
1X 	X 00000 00000001
100000 00 00 0XX	001
100000 0X0 00 X00001
100XN0000X0000000X01
100000X0 00000 	0001
10  00 00X	00XX		0 1
10XX0000000000	00001
10000X0 00X	000	0001
100000000 000 0 X001
10	00X000000000X0X01
11111111111111111111
