NO test_artifacts/valid.xpm
SO test_artifacts/valid.xpm
WE test_artifacts/valid.xpm
EA test_artifacts/valid.xpm
F 78,38,201
C 61,217,1

11111111111111111111
10000 0	00000000X001
1000 00X 0X000000001
10000 X0   000X 0XN1
10000X00000X	0000001
10 0000X000 00000001
100XX0X00000    0X01
10X0000X000000000X01
1000 0	  00	0 000001
10000000000X 00000X1
1000	X0	00XX0X0XX0X1
10X 00 0000X00000001
1000 0000000000 0  1
1	X0000000000000 001
10000 00  00 0000001
1000 000000000X0	 01
1000000 0000XXX0 001
100X0000000	00000001
100000 0	000000 0 	1
11111111111111111111
