NO test_artifacts/valid.xpm
SO test_artifacts/valid.xpm
WE test_artifacts/valid.xpm
EA test_artifacts/valid.xpm
F 176,,0,0
C 146,251,106

11111111111111111111
1X00000000X	0 X0 001
1X 00000XX0000000001
1X00 000X000 0000001
1 XX0000  0000000X01
1000	X0000000	0000	1
1X000 00000	0	000001
1XX  0X00	0 00X00001
1	X00XX00X0 000X	001
10	000000000000 0001
10X00		00 00X0 000 1
10000X00 0000000X0 1
100 X0X00000000 0001
10 000000000X00X0001
1000000X0  0000 0001
10 X0 00 0	000000001
10000 00X0N0000   	1
100X000000000000X	01
1000000X000000X	  01
11111111111111111111
