NO test_artifacts/valid.xpm
SO test_artifacts/valid.xpm
WE test_artifacts/valid.xpm
EA test_artifacts/valid.xpm
F 71,81,244
C 176,170,0

11111111111111111111
10100000001001000001
10001001010100000001
10000000000000100001
10101000000000000101
10000000000100000001
10000000000000000001
11000100111001000011
10001000100100011111
11000100010100000011
10001110000000100001
10000000000010000001
10000001110000010101
10000000101100000001
1001000000000N010001
10000001011100011101
10001000010000000001
10000110000101100101
10000101001000011001
11111111111111111111
