NO test_artifacts/valid.xpm
SO test_artifacts/valid.xpm
WE test_artifacts/valid.xpm
EA test_artifacts/valid.xpm
F 195,0,0
C 222,32,17

11111111111111111111
1X0X0000	0X000000	 1
10 000000000X	 00001
10 00000000	0 00	001
10	0 00	00000000X001
1X0 000XX0000X0XX0 1
100000X00000XXX00001
100000 0 0000000	XX1
1X0	0  0000 0000X0 1
1000X000000	0X00XX01
100	X0X000	00X00X001
100000X 00 	00 00001
10000000X00 X0	00001
10X0X0000 0	000 0001
100  0	X00	X0000X001
1 X00 000 0X0X0X0001
1  000000000 0 00X 1
1N000000 00X 0000001
1	0 000X00	  000X0	1
11111111111111111111
