NO test_artifacts/valid.xpm
SO test_artifacts/valid.xpm
WE test_artifacts/valid.xpm
EA test_artifacts/valid.xpm
F 128,175,169
C 179,120,104

11111111111111111111
1000000 00X000 00001
10X	X000000000000	01
1000	0000	0 0000 001
1000 00X0000 000X0X1
10000000000000000001
10X00000000000 00 01
100 000 00000X000001
10 X0X0 0000	0 0X001
1 	00 XX XX0 0000X01
1000 X000			000	0001
10000000000X00 0X	01
1	00000000000000X	 1
10 000X0 0X0000000X1
10	0	000X 0000000001
100 000 0X	00X000X01
10 X000	00X0  0000 1
1000000		XXXX	000001
10N 000000000000  01
11111111111111111111
