NO test_artifacts/valid.xpm
SO test_artifacts/valid.xpm
WE test_artifacts/valid.xpm
EA test_artifacts/valid.xpm
F 151,168,55
C 1,62,230

11111111111111111111
1X0000000 000X0	 001
10	0000 000000000001
1	000X0000		00000001
1000000 000000  X001
1000	000000XX0000001
1000	X0X000000000001
1000	0X000	X00000001
10X 0 X00X000X	00001
100	000000 0000000X1
10000 X0 00000000001
1	000000000X0000 001
10000X00 X00000 00X1
100XXX0000000X0 0 01
100 0N0X0		000	00001
1000000	00	00 00X  1
10000000000000000001
10000X	0 	00 00000 1
1 00000000000000		01
11111111111111111111
