NO test_artifacts/valid.xpm
SO test_artifacts/valid.xpm
WE test_artifacts/valid.xpm
EA test_artifacts/valid.xpm
F 124,174,6
C 245,217,75

11111111111111111111
10X000  0	 000000001
1 00  00000000	0X001
10N0	 000000X0000001
100000000000 0	X0	X1
10000000000	0 000	01
1 X00000000	XXX000	1
10	00X	00000000X0001
10X	X0 X0	00X0000001
1 00000X0 00000	0001
10 000 000	0X	000001
10000 000000000 0001
1 00000 	000X0000001
1 00000 0 X00	0 0001
1 00 0000 00  000001
1	000XXX00000 0000 1
100 X 0X 000 00 0001
100000000X00000 0001
10000000000000000001
11111111111111111111
