NO test_artifacts/valid.xpm
SO test_artifacts/valid.xpm
WE test_artifacts/valid.xpm
EA test_artifacts/valid.xpm
F 132,223,205
C 189,0,120

11111111111111111111
1000X 00000000000001
10000 X00 000	000001
10X0	XX0	0000	 00X 1
100 000000	00 00X 01
1000X0 0000	0 0	0001
1 000000000	 0X0XX01
100 X000000000X0	001
100X0	00000N0 00	 01
1000	000	0 00 0000 1
1000000X 00000000001
1X000000 00000	0 001
100	0	 0000000000001
1000000000 0	00 0001
1	000X0 000XX0000001
1	00X0	00	0 00000001
1 X0000 0000000 00X1
100000 0X0000 000001
1000 000000  000X001
11111111111111111111
