NO test_artifacts/valid.xpm
SO test_artifacts/valid.xpm
WE test_artifacts/valid.xpm
EA test_artifacts/valid.xpm
F 202,217,59
C 108,29,25

11111111111111111111
10 00X0XX000X 0X0001
10000000 0000 X00X01
1X 0000	000000 00001
1000000000XX0X0	0	01
10	0X0000000X0000001
1000 000N 0 	0000  1
100000X0X00	 0  00 1
100 	000000000000001
1X00X0000000000 	X01
10000 0000 0X	000X01
100 X00	000000 00001
10 000 	00000 	00001
100X00000000X00X  01
100X000 0000000 0001
1X0000000X 000000001
10000  0000000000001
100000X000 00 0 X001
100 00XX0	0 X0 0	001
11111111111111111111
