NO test_artifacts/valid.xpm
SO test_artifacts/valid.xpm
WE test_artifacts/valid.xpm
EA test_artifacts/valid.xpm
F 216,93,254
C 66,75,68

11111111111111111111
10X0	000000000X00	 1
100X00 0X  X0X0	00 1
100	0000X000X0000X01
1X00 0 000X000000001
10000 00	0000000 001
1	0000 0 0  00000 01
10000000X	000X  0	 1
100X00000X 0	XX00001
100000000X00 000 0X1
10000000000X000	0001
1	0000000000XX0	0001
1	0 000	00X  00	0001
1X00 0 N0X00 0 00001
1 000  000000000  01
1X 0X 0 000000000 X1
1000000X000 0 0000X1
10	0X 0000 0000 0001
10	0000 0 00000XX0 1
11111111111111111111
