NO test_artifacts/valid.xpm
SO test_artifacts/valid.xpm
WE test_artifacts/valid.xpm
EA test_artifacts/valid.xpm
F 40,206,136
C 54,95,213

11111111111111111111
10000000000	 0 00X01
10000000X 00000X00N1
1000X00X0 0000 000 1
1 000	 00	0000X00X01
10000X00 0 0	 0 0001
1000000000 0XX X0001
1 00 		0 00X0X0   01
1X000000000000X00X01
10X  	000000000000	1
1000 X0 X00 	00X0X01
10X0	00000000000	 01
1000X00000000000 	01
100000 00000 0X0	001
1000 0  000000 0 0X1
100	00	00	000	 00001
1000 X	X00	X00000X	1
1X0000 0000000000  1
10X00XX00000X000 001
11111111111111111111
