NO test_artifacts/valid.xpm
SO test_artifacts/valid.xpm
WE test_artifacts/valid.xpm
EA test_artifacts/valid.xpm
F 103,0,0
C 28,253,194

11111111111111111111
10000 00	000	00000 1
1	0	X0000X0000000001
1000000000 00 	000 1
1000000  00X00X00	01
100000000 	000 X	001
1000000X000	00 0X001
1X00XXX0X000X	0000 1
10000X0X0000000 0X01
10 00X	000	0	 00	0X1
10 00000 0XX00	00001
1 00	0000000000X0001
10X00X0 00	0	X000 01
100000XX00 0	0000X01
100000000  0 0X0 001
1000	0X0000 00 0X 01
100 0X000N0	0	000 01
1000	0 X000000000X01
10000 0000000000X 01
11111111111111111111
