NO test_artifacts/valid.xpm
SO test_artifacts/valid.xpm
WE test_artifacts/valid.xpm
EA test_artifacts/valid.xpm
F 195,27,138
C 37,31,177

11111111111111111111
10X00000000X00 0X0	1
100000	 X0 000000 01
1X00X 0 0000X00000X1
10000X0000 0000 X001
10000000X000000000 1
100000  000 00000001
100X0000000000000X01
1000X00	X00	00X00 X1
10N	00XX0 0000XX00 1
100X	000000000000001
100X00000000X0	0	001
1000 0X 0000 000	0 1
10X0	000 X0000000001
1000XX0000000	000001
10000 000	000X 0	X01
1	000X0	X0 0XX0X00	1
100000000000 0000001
100X00	000000000X001
11111111111111111111
