NO test_artifacts/valid.xpm
SO test_artifacts/valid.xpm
WE test_artifacts/valid.xpm
EA test_artifacts/valid.xpm
F 186,9,80
C 154,114,151

11111111111111111111
10010000000100010001
11000000000010001001
10100001000001000001
10000000000000010101
10100000011000111001
10000001011110000001
10000001010001110011
10100000000000001011
1000N000000000101001
10000000000000000001
10000000110101011001
10000100100001001001
10001010001100110101
10000000000100110001
11000011100000000001
10000100110000000011
11000000001000000101
10000001000001000001
11111111111111111111
