NO test_artifacts/valid.xpm
SO test_artifacts/valid.xpm
WE test_artifacts/valid.xpm
EA test_artifacts/valid.xpm
F 183,62,144
C 253,72,118

11111111111111111111
10000X	000 00 000001
10000000000X0	000001
100	0X00	 0X00000001
1000 X0	000000000 01
100000000	 00000 0	1
1 0000000000000000 1
1000 000N00000X0X001
100	0X00	0	0000000X1
100000000000 0	00001
10X0XX0	 0 0000  0 1
1	0 00000000		0X0001
1000X000000000000001
10000	 0000 XX0000X1
100000	00 0	0 X0 0X1
10X0	0000X00	 000001
1XX00000X0000	 00001
1X0000000000X00000X1
100X	000000 0X0X0001
11111111111111111111
