NO test_artifacts/valid.xpm
SO test_artifacts/valid.xpm
WE test_artifacts/valid.xpm
EA test_artifacts/valid.xpm
F 10,49,113
C 8,107,3

11111111111111111111
10000011000000000111
10001000001010000001
10100000001000000001
10100011001000000001
10000001000100000001
10010000100000000001
11011000010000000001
10000101000010110001
10010001100100010001
10100000001100000001
10101001010100010001
10000000000000000101
10000000000000000011
11000001000000000101
10000000100000001001
10000N00011000000001
10000000000000000011
11000000000000001101
11111111111111111111
