NO test_artifacts/valid.xpm
SO test_artifacts/valid.xpm
WE test_artifacts/valid.xpm
EA test_artifacts/valid.xpm
F 158,253,127
C 174,123,149

11111111111111111111
1 00000000	000000001
100000X00X0000000001
100X0N0 X00000000001
100 XX000	0 	00 0001
1000 0X000000X00 	01
1X 000 00000 0000001
1X00000000 000000X01
1 000000000000 00001
1 0000000000 000 001
100 0	0000 0000000 1
100000 0000X0000  01
1000	00 0 0	X00	0001
1	000000000000000001
10X000000	0 	X00XX01
100000X00  000000 01
1 0	0X 		0000000  01
100000 X0000000  001
10X000 X0000 0X00001
11111111111111111111
