NO test_artifacts/valid.xpm
SO test_artifacts/valid.xpm
WE test_artifacts/valid.xpm
EA test_artifacts/valid.xpm
F 241,47,19
C 16,168,195

11111111111111111111
10 00 X000		 0000	01
1000000X000000000  1
1 XX000 00 	000X00 1
1X	000	  0000X0X0X01
100000000 0000	  001
10000 0000X00X000XX1
10X00000000X0000  01
100000000000000000X1
100 00XX000000 00001
10X0000 X00000	00001
100000X0	00000NX0	 1
10000X 000 000000 01
1X000X 	0  X000X0001
100000000X00 000			1
10X00	00 00000000001
1X0000 0000	00 00001
1	00000000000000 0	1
1000000000  0 X0 001
11111111111111111111
