NO test_artifacts/valid.xpm
SO test_artifacts/valid.xpm
WE test_artifacts/valid.xpm
EA test_artifacts/valid.xpm
F 130,195,37
C 86,126,120

11111111111111111111
11000001010100000001
10001000010100000011
10000000000100001011
10010000001000000001
111010000010000N0001
11000000000100000001
10000000001000011001
10000000000001000001
10100001001100010001
10010110000100000001
10000000000000001011
10010000100000001001
10010100100000000001
10111000100000100001
11000000000000010001
10010000000000000001
10001000010010001001
10010000001000000101
11111111111111111111
