NO test_artifacts/valid.xpm
SO test_artifacts/valid.xpm
WE test_artifacts/valid.xpm
EA test_artifacts/valid.xpm
F 240,0,0
C 99,181,11

11111111111111111111
100X000000000  0	0 1
10000X00000X000	0001
1 000000000X00N000 1
1000000 X0000	000001
10 0000XX00X 0X00001
1  0X0X0000X00000 	1
10  00000 0 0 00X  1
1 0X 0000000 0		0001
100000000  0000000	1
100000000000000	0 01
10 00 0 X	000000	001
1000000000 000000X01
10	0 0000X00	0000001
100000X 0000000000X1
10000	0X000  0000001
1 0X000000000 X00X01
1000X000X000000XX001
1   0X000X0000X000X1
11111111111111111111
