NO test_artifacts/valid.xpm
SO test_artifacts/valid.xpm
WE test_artifacts/valid.xpm
EA test_artifacts/valid.xpm
F 15,78,39
C 191,204,58

11111111111111111111
10100010000010001001
10000100000000001001
11000001000000110001
10001000000000010001
10000010000000010001
10000000000100000001
11100010000000111001
10000101010010000001
10001000101010100001
10000000010000000N01
11000100010000000001
10000010001000000001
10110000001000000111
10010000000001000001
10000001000000000001
10000000000010000001
10000000011011001101
10000001010000010001
11111111111111111111
