NO test_artifacts/valid.xpm
SO test_artifacts/valid.xpm
WE test_artifacts/valid.xpm
EA test_artifacts/valid.xpm
F 46,170,34
C 154,221,51

11111111111111111111
10001000000000000001
11000001000001000001
10100000100000100001
11000000001000100011
10100000000000000011
10000000000000000001
10001000000000000001
10000001100010100001
10000000000000001001
10001000000000101001
100000010N0000000101
11000010000000000001
10000000000010000101
10000100000000100001
11010100000000101001
10100000001001000001
11000000100001010011
10100000000010000001
11111111111111111111
