NO test_artifacts/valid.xpm
SO test_artifacts/valid.xpm
WE test_artifacts/valid.xpm
EA test_artifacts/valid.xpm
F 110,221,196
C 40,23,183

11111111111111111111
1 00000	00000000X001
1X0 000 0	00000	0001
1000X000000000000001
100000000X X000000X1
10X0000  000 0X00001
1 0000000000X0 00001
1 0X000XXXX000000N 1
100XX00X0X0 000000X1
1X000X	000000X X0	01
1000X 0000	000000001
10X00000	00000000 01
10X00XX0X0	0 0000001
1X0000  00 000 00001
1	000000	00X000 0001
1X00	00X000X00000X	1
100000X00 0 00000001
1000XX00X 0000000001
1000000X0000 00	0001
11111111111111111111
