NO test_artifacts/valid.xpm
SO test_artifacts/valid.xpm
WE test_artifacts/valid.xpm
EA test_artifacts/valid.xpm
F 17,161,204
C 171,34,22

11111111111111111111
10000111000001000101
10000000100100100001
11010011000000011001
11000000001000000111
10000010000100100001
10000001000100010001
11010011011000011011
10001000010001000011
10001000000000101001
11000000110001011111
10010010101001010101
11000010001010000011
10000100010000000001
10000001000000000101
10000000100010001001
10010001000000100001
10010N01110101000001
10000001000100000011
11111111111111111111
