NO test_artifacts/valid.xpm
SO test_artifacts/valid.xpm
WE test_artifacts/valid.xpm
EA test_artifacts/valid.xpm
F 27,204,96
C 134,24,56

11111111111111111111
100X00000 000 00	0X1
1 00000000 00 000  1
10000000	000X0 00 	1
10000000000000000001
100X 0	0000X  0X0 01
10000000000X00000001
100		00000X	00000 01
10N000000000X 000001
100 0 0 0000X00000X1
10 0	00000X000	 0001
1000 000000000000001
10 000X000000000   1
1 X00000X00000000001
1	0XX000	000000000X1
1 00000X000000 0  01
1000X00000000X 00001
10000X00X000X00000	1
1XX0000000X 000000X1
11111111111111111111
