NO test_artifacts/valid.xpm
SO test_artifacts/valid.xpm
WE test_artifacts/valid.xpm
EA test_artifacts/valid.xpm
F 195,0,0
C 215,187,194

11111111111111111111
100000 00 000	000001
100 0 00	 00X0 000X1
10000X	00000X0000001
10X00X 00X00 00 00 1
10000X0000000	000001
1	 00000000000000X01
100000000X000	000  1
10XN000	0000	0X00X01
100000 0000X X0	 X 1
1 0 00000000000 0001
100 0 000000 0X000X1
100000000 00000 	 01
1X0000000X0X000  001
10X00X000000000000X1
100000	0 00000000X 1
10000000	00000000001
10 0000000  	 000001
1000000000 00X000X01
11111111111111111111
