NO test_artifacts/valid.xpm
SO test_artifacts/valid.xpm
WE test_artifacts/valid.xpm
EA test_artifacts/valid.xpm
F 255,36,72
C 193,154,116

11111111111111111111
10011000010000000001
10000000000000001001
10000011000010000001
10101000010001000001
10000000000000000101
101001000N0000001111
11000000000000001101
10000001100100000001
10000100001011000001
10001100000001000001
10100010100001010001
10000000000000000001
10001000100110110101
10110000100000001001
11011000000010010001
10000000000100100001
11110000001011000001
10000101001000010101
11111111111111111111
