NO test_artifacts/valid.xpm
SO test_artifacts/valid.xpm
WE test_artifacts/valid.xpm
EA test_artifacts/valid.xpm
F 224,6,252
C 169,145,172

11111111111111111111
11010010011000100011
10000000000000010001
100000000010N0000101
11100000100000010001
10000000100001110001
11010000000000111001
11100110011001000001
10000000000000000001
10100011000000000011
10000010000000101111
10001000000001000001
10110000010000100001
10100100011000000001
10000000001000000001
10100010100010110001
10000100011010000001
10000000000100000101
10001100000010000001
11111111111111111111
