NO test_artifacts/valid.xpm
SO test_artifacts/valid.xpm
WE test_artifacts/valid.xpm
EA test_artifacts/valid.xpm
F 215,0,0
C 31,107,130

11111111111111111111
100000	 0	00X000 0 1
100000000X0 	00000 1
1000	00 0000 0000001
10000000X 0000	 0001
1 00X000X  00000 001
1000	00000	X00	00X01
100X000000000	0X0X01
1000000000X 00000 01
1X000X000000 0000001
100 0 000 	000000	01
1000000 000000000001
1X0000000	0XXX000 X1
1 00	X	00000000XN0X1
10   00X0000000000X1
10X 0000X  0000X00 1
10000000  	0X00XX0 1
10 X000	00	 0 000 X1
1X00X00	  00000	0001
11111111111111111111
