NO test_artifacts/valid.xpm
SO test_artifacts/valid.xpm
WE test_artifacts/valid.xpm
EA test_artifacts/valid.xpm
F 75,8,239
C 186,114,229

11111111111111111111
100000000X000 000X01
1X0	00X000000 0 0001
1000X 0	0000000X X01
1X000000000X0000X001
1000 00  00000000 01
1000N0X00  0	0000001
1000X00 000 0000X001
1 	0 00X 0X000000001
1000000000 0 0000001
10000 00 XXXX0X00001
10000000000000000001
1000	 0000  0000	X01
1	0000	00 000000X001
100000X000000000 0X1
100X000000X000 00	01
10000	0000 00	000001
1 0 	0 0	00000000 01
100 X0	000X000000X01
11111111111111111111
