NO test_artifacts/valid.xpm
SO test_artifacts/valid.xpm
WE test_artifacts/valid.xpm
EA test_artifacts/valid.xpm
F 27,,0,0
C 226,208,172

11111111111111111111
10 00000000000XXX001
1000X 0	0	00X0 00	 1
10000 0X0X 0X 00X0 1
1 0X00000000	N000XX1
10 0X0000X0000000 01
100	0 00X000  X0 X01
10X0 0X0X0000X0X0001
1 0000XX0 0 00000001
1000 0  000000	00001
1000X0000X00000 0001
1000	0 000000000X001
1 000X0000 000	0XX01
1000000X0000000000 1
1000000X0000000000X1
10000000000X 0	00 01
1X0000000 00000000X1
1 000 00000X0000	0X1
10  0	0000 000X00001
11111111111111111111
