NO test_artifacts/valid.xpm
SO test_artifacts/valid.xpm
WE test_artifacts/valid.xpm
EA test_artifacts/valid.xpm
F 174,154,180
C 177,52,15

11111111111111111111
100X0X00000000000X01
10000X0	00 XX00X0 01
100 000000	 	00000	1
10X00X  00000X0000 1
1000000X000 0	000	01
1000	00XX000X00	  01
10000000	0X0XX00	0 1
10N00 0XX 00X00XX001
1000X00 0XX00000	X01
1000X00 X	000XX00001
1X00000000 0 X000 01
10000X00 0000000X	01
10X0 000 0000 000001
1X  0000 00000000  1
10	00	0000000	0X0	01
1X0	000 00 00000 001
10000XX0X00000000001
1 0000 0000000000X01
11111111111111111111
