NO test_artifacts/valid.xpm
SO test_artifacts/valid.xpm
WE test_artifacts/valid.xpm
EA test_artifacts/valid.xpm
F 177,236,161
C 87,83,102

11111111111111111111
10 00X0XX 000	X0 001
100000000 00000X0001
1 000000000 00 00001
10X000 0	0000X0X00X1
100X000 0X000000X X1
10 00000000 0 XX0001
100000	00	0X0X0 		01
10 000000X00XX000X01
1	000000000		00000X1
1 0X0	0X000 000000 1
1X00000X 000 00 00 1
100000 0	000 0000 X1
1 000000000 00  0001
10 0N000000 0 000001
1000XX00000 000XX001
10X0 000000000X00001
1000000	0 00	0	0X001
10	X0X0000X000000X01
11111111111111111111
