NO test_artifacts/valid.xpm
SO test_artifacts/valid.xpm
WE test_artifacts/valid.xpm
EA test_artifacts/valid.xpm
F 229,96,119
C 140,80,119

11111111111111111111
10000000011000000001
1001000000000100N001
10000100000000000001
10000000000100010001
10000010000000000001
10000010000101100001
10110100000010000001
10100010000100000111
10000100000001010001
10000010010100000001
10001101100001100001
10000100000001010011
10100001000001011101
10010001100001010001
10110100100001000001
10000001000000000001
10000000000100000001
11000000101010011101
11111111111111111111
