NO test_artifacts/valid.xpm
SO test_artifacts/valid.xpm
WE test_artifacts/valid.xpm
EA test_artifacts/valid.xpm
F 87,181,144
C 191,176,179

11111111111111111111
10001001000001000001
10001010000001100011
11000001110100000001
10101000010010000001
10000010010000001001
10100100000000000001
11000100000010000111
10000100000101000001
1100000N001100000001
10000000000000100101
10000101000010010001
11001000100001000011
10011100000010000001
11100001000001000011
10001000001100001011
10000010010000000001
10000000000000000001
10000001000001000001
11111111111111111111
