NO test_artifacts/valid.xpm
SO test_artifacts/valid.xpm
WE test_artifacts/valid.xpm
EA test_artifacts/valid.xpm
F 251,43,101
C 20,163,239

11111111111111111111
10100100010000000001
10001001000000100001
10001100100110000001
11000100000001101001
10010000100000001001
11010000000110100001
11001010000110000001
10000000000000000101
10010000010000000001
101100N0000000000001
10100000001100010001
11100010000110001001
11100001000000000011
10000000001000011001
11001000001001010001
10010100010100001101
11100000001001000001
10000010010000100001
11111111111111111111
