NO test_artifacts/valid.xpm
SO test_artifacts/valid.xpm
WE test_artifacts/valid.xpm
EA test_artifacts/valid.xpm
F 118,186,55
C 42,3,245

11111111111111111111
1000000X0	0XX00000	1
100000000000000000 1
1 000X00000000000001
1 00 0	0  0	00 00X01
1X000	0XX 0000000X 1
100	X0	0000000000001
10000000X  000000	01
1X 0000000000 00X001
1X0	 00X0000000 	 01
100000000X 0	0000001
10000	00X0X000 00001
10 00000X0X000 0 001
100X 0000X 0000	0001
10000 0 000X 00X0001
10000000000000X00001
100NX0	 00000000X001
100X00 	0000	00XX001
1 00	0000 0XX000X		1
11111111111111111111
