NO test_artifacts/valid.xpm
SO test_artifacts/valid.xpm
WE test_artifacts/valid.xpm
EA test_artifacts/valid.xpm
F 170,164,166
C 144,221,63

11111111111111111111
1000000X0	0	0	 0XX01
1000 000000X	0X  001
10X0	0000000000  001
10000X0X00000 000001
1  000000 000000 001
10X00	000X0X00000001
10000	000 000X000001
1	0000X0000 000000 1
1000000000000000 001
1X00 00000X000 00001
100 0000	00000XN  01
100000000XX000000001
10 X00000000000000 1
1000000 000 0000 001
100000000000	0 000 1
10X0	 	00000X00000 1
100X00	0		0000000001
100000000000 0000001
11111111111111111111
