NO test_artifacts/valid.xpm
SO test_artifacts/valid.xpm
WE test_artifacts/valid.xpm
EA test_artifacts/valid.xpm
F 207,132,145
C 199,153,240

11111111111111111111
1000000X00000X000001
1	000000X000 0000X01
10000 000000000X 0 1
10000X0 0	  000 0 	1
1000000000X0X0X 0001
1	00 000000X0 00 001
100 000000	0000 0001
10000000000000X00001
10X000	00 0000	000X1
1X00000000000000 001
10 X00000X00X000 001
100X0	000XX00 000001
10 0 000X00000X000X1
1000 X00000000000 01
1000000000000	0X0001
10000000000000	000X1
10N0 000000000X0X 01
10	 	00 X00 0 000001
11111111111111111111
