NO test_artifacts/valid.xpm
SO test_artifacts/valid.xpm
WE test_artifacts/valid.xpm
EA test_artifacts/valid.xpm
F 220,176,39
C 250,29,187

11111111111111111111
10000000X000 000	X01
10  	0	000000000X001
10  X00 00	0 N00XX01
10X0	 00 00000 00001
1X0	 00000	00 0000X1
1000000000000 000001
100 000	000000X00001
1 0 X00 0000X	X0	 01
100X000000 00X000 01
10X0000000	00X00 001
1 0000X000 0000000X1
100000X	 000	000 001
10X00X0000 000000X01
1  000X00000000X0001
100XX000	0 0X0000 01
1	00 000000000000X01
10  0000000 X 000 01
1X0000 000000	0000X1
11111111111111111111
