NO test_artifacts/valid.xpm
SO test_artifacts/valid.xpm
WE test_artifacts/valid.xpm
EA test_artifacts/valid.xpm
F 198,116,165
C 153,105,15

11111111111111111111
1X0000 X00 0000000X1
10  000 0000000000 1
1	0 0000 0X0000 0001
1	00 000000000000001
10000000	0X 00000 01
1X00X00000000 000001
100 00000 000 000 01
1000X00 00X	0XX	 001
100 00 0 0 000000001
100 X00000 0 000  01
10 0000 000000000001
1000 00X0	00 0000X01
1000000X00000X00	001
100000	 000 0   0	01
1 00 0 0000X0 X00X01
1000000	00N0X00X0001
1	0		00X X00X0 X0 01
1	000000 00	000000X1
11111111111111111111
