NO test_artifacts/valid.xpm
SO test_artifacts/valid.xpm
WE test_artifacts/valid.xpm
EA test_artifacts/valid.xpm
F 3,112,237
C 178,13,247

11111111111111111111
100000   0XX  000001
1 00X 00 00000000001
10 000000  000 00001
1000000X000000 X0X01
1X  0000X	0000000 01
100000 00 0000000  1
100X00000X000000N0 1
10	00 000 X000000001
10 	0X000000 00000 1
10X00000000000 	0	01
10 00 0  	000XX000 1
10	0000 000 00000 01
1	0000000X0000X00001
1 00000000X00000	001
10	 	000000000000001
100XXX 00 000X000001
1X0000	00000 X0X0	X1
100X0X 	X0 X000  X01
11111111111111111111
