NO test_artifacts/valid.xpm
SO test_artifacts/valid.xpm
WE test_artifacts/valid.xpm
EA test_artifacts/valid.xpm
F 38,179,86
C 193,243,222

11111111111111111111
1	0000 XX 00XX00	0X1
1XX00000X00X0000 001
10 0000XX00000000001
100X000000XX000	00X1
10 X000 X0000X00 001
1X0000X00X000000X X1
1N0 	X00	0 00	000001
10 0 0XX0000 00000X1
100X000 000000000001
10X	00000XX 0000 001
1X00000000000 X00XX1
10 0   	X0XX00	00X01
1000000000000	00X001
10 000 0X0 000000001
10 0000 000000 0	001
1000000000000X0 0001
10 0 000 00	000X	001
10 XX00000 0000 0001
11111111111111111111
