NO test_artifacts/valid.xpm
SO test_artifacts/valid.xpm
WE test_artifacts/valid.xpm
EA test_artifacts/valid.xpm
F 208,115,65
C 217,237,109

11111111111111111111
10000011100000010001
10010010000000000001
10000101000000001101
10100000000100000101
10000000000001110101
10101100000000001001
11000000000100000011
11100100010000000101
10100100000000000001
10000000100000000011
100000000000100N0101
10010001000000000001
10010100000000010001
10000100000100000101
10000011000000000001
10000000100100100001
10000001001100011111
10000000101010000011
11111111111111111111
