NO test_artifacts/valid.xpm
SO test_artifacts/valid.xpm
WE test_artifacts/valid.xpm
EA test_artifacts/valid.xpm
F 245,242,3
C 8,30,55

11111111111111111111
10100101000000000001
10100001000000000001
10001000000100010001
101010000N0100000001
10000100000010000001
10000000001000000001
11100100000000010111
10100000000001000011
10101000000000000001
10000001010000000001
10000100000000000001
10010011010000000001
10101010000100100001
11110100000000000001
11000100010100000001
10001000001000100001
10100010000111000001
10101000000000011001
11111111111111111111
