NO test_artifacts/valid.xpm
SO test_artifacts/valid.xpm
WE test_artifacts/valid.xpm
EA test_artifacts/valid.xpm
F 223,90,237
C 149,208,140

11111111111111111111
10000000XX00 000N0X1
10 0000X00000	00	001
1000000000	00000 001
100000000 00 0 00001
1XX0000X00	000000001
10000X	000000 000001
10	00 00000 X00 	001
1X00000	00 00 000 01
1000   000	0	0000X01
1X000000 00000000001
10 X00X00000000 0 01
10000000 0X0X0000001
10000000000000000X01
1000X0000 000000 001
1	X 000000 0XX0000X1
1000	000X X00000 001
1000000 	00X	00	0001
100000000	00000000X1
11111111111111111111
