NO test_artifacts/valid.xpm
SO test_artifacts/valid.xpm
WE test_artifacts/valid.xpm
EA test_artifacts/valid.xpm
F 167,0,0
C 229,184,194

11111111111111111111
100000000000X0000 X1
1000000000  00000001
10 00000	00000 00001
1000 X 0000 0	X0	001
1 0000000000X0000X 1
1X0000X000X	00000  1
10000000000X0000X001
100XX000	00000000001
10	000	0XX 000000001
100000XX0X000 0X00	1
10 00000000	  000001
1X000000 	00000X0X01
10	00	 0X000X 00X X1
1000X000 00 XX0 0	01
10 0 00 000	X00X0X 1
1	000000X	0000X00001
1X 	X0 0000	X00000N1
10X000000X00	X000X01
11111111111111111111
