NO test_artifacts/valid.xpm
SO test_artifacts/valid.xpm
WE test_artifacts/valid.xpm
EA test_artifacts/valid.xpm
F 47,51,90
C 188,27,245

11111111111111111111
10000000000XX 000001
1000	000	 0	X0000 01
10 00 0X000000 00 01
10XX000000000	 000X1
100  0	X0000X0000001
100X00000000 000 001
100 000000000000  01
1000X0X00 00 XN0 X01
10 00XX0 000000	0001
100X0000000000X000 1
100000000000XX000	01
10  0 000000000 0	01
1000000	00 X000000X1
10XX0	00000000000 01
100000000000 0000X01
1 000X00 0000 00 001
1000000 0	 00000X0 1
100 00 0X0000X0000	1
11111111111111111111
