NO test_artifacts/valid.xpm
SO test_artifacts/valid.xpm
WE test_artifacts/valid.xpm
EA test_artifacts/valid.xpm
F 3,,0,0
C 53,109,157

11111111111111111111
10000000X000000 0001
1000	000  0000	00001
1X	0X	0X	00	00000001
100 0000000000X00001
1X0000000	00XX	0	0N1
100000000000000 X001
1000X000000 0	 00001
100XX0	 000 0 000001
100X0	0 0000000000X1
10 00000000000000001
1X000	0	0 0000 00001
10X00X00000000	 	001
10X0 0000  000000001
1 000  0X X0000X 001
10000000000000X00001
10000000 00000000001
10000	000000000 0001
1 0X 0000	0000XX0001
11111111111111111111
