NO test_artifacts/valid.xpm
SO test_artifacts/valid.xpm
WE test_artifacts/valid.xpm
EA test_artifacts/valid.xpm
F 242,164,234
C 235,5,7

11111111111111111111
100000  0000000X 001
1000 	XX N0000X000 1
10000000	00 X0	X00 1
1	0000 X 00 00000X01
10	 00X000000X0X0001
10 0000000 000000001
10XX0 00000000 0X001
10X0000X00000 000001
1	0X0000X0	000000001
10000 0X00 0000X00X1
100X 0000X0  000  01
1 00X000X00X0X00X001
1000000	00000	0 	001
10 X000000X000 00001
10X 000000000 000001
1000 000000	0 00X 01
1	0000000000X00000 1
1 0XX0X0000000	0 001
11111111111111111111
