NO test_artifacts/valid.xpm
SO test_artifacts/valid.xpm
WE test_artifacts/valid.xpm
EA test_artifacts/valid.xpm
F 182,85,190
C 17,223,151

11111111111111111111
10	00000X00000000001
100000000X	000000001
100000	000X00X00 001
1000X0000	X0XX00 001
1X00X0	 000000000001
10000000X0 0 0 0 001
100  0X00000	0	00001
10X000000X0000000001
10000000X000000 0X01
1 000000X00 	0000X01
1X000000X00 0000X001
100000000000000000	1
100	00X00X 00	0X0 01
100X0X0	X00000X0 001
1 0	0000 0	0000 X001
10 00000000  000 001
1 000X000	0	0 00X001
1000X00N0 0 0	0X00 1
11111111111111111111
