NO test_artifacts/valid.xpm
SO test_artifacts/valid.xpm
WE test_artifacts/valid.xpm
EA test_artifacts/valid.xpm
F 228,146,150
C 168,107,9

11111111111111111111
10 0 000000000000001
1000000 X 0X0000X001
100000	0 00 00000001
1	0 X0	00000000 0001
100X00 00000X00	0XX1
100	0	00000000000001
1X0 00000 0	00X00	01
1000X 000000 0	00001
1 000 0	0000X0000X01
10000 0 X000000 0 01
100X00 00 0000X0 001
10000 0000X0	0000X01
1 0 00 X0 00N0000001
100000000 0000000001
100X0000X0000X0	0 01
1X0000000000000 0X01
100X0 0X000000000	01
100000 0 0	00X	00X01
11111111111111111111
