NO test_artifacts/valid.xpm
SO test_artifacts/valid.xpm
WE test_artifacts/valid.xpm
EA test_artifacts/valid.xpm
F 177,119,60
C 1,232,35

11111111111111111111
10000001000001000001
10100000001001010001
10010000000100001101
11010011000100000001
11001100000100000001
10000001000110001001
10010000000000101101
10000011000101110101
10101000000000010101
10110010101000001001
10000000001010010001
11010100000100000001
10000000000011000N01
10010010110001000001
10100000000000000001
10011100100010000101
10000010000001010001
10000000100010000011
11111111111111111111
