NO test_artifacts/valid.xpm
SO test_artifacts/valid.xpm
WE test_artifacts/valid.xpm
EA test_artifacts/valid.xpm
F 94,182,69
C 83,226,99

11111111111111111111
10X00 000000000X0001
100000	000000	000001
1 0000X 000X0000	001
10 X0000	000000000 1
10000000000X0X0X 0X1
1000 00 000X000XX001
10000000 0000X000 01
10000000 000 	 00001
1X00000000000 000001
100000X00  X00 0XX01
10X000000X00X0000001
10X00 0	0000	00 0001
1	00	00000	X0	X00X01
10X 00000XX0X0X00001
1X0X 000000000	00  1
100 0000000 0 000001
1000X 00000000000X01
1 00N00	0XX000000001
11111111111111111111
