NO test_artifacts/valid.xpm
SO test_artifacts/valid.xpm
WE test_artifacts/valid.xpm
EA test_artifacts/valid.xpm
F 17,206,102
C 206,77,231

11111111111111111111
10100000001000100001
10000000000001000101
10000010100000000001
10000001000010000101
10000000000000000001
10000000010000000001
10000000010000000001
10100000100100001111
10001001000000101001
10000100000001000011
10000100010000001001
10010000010001100011
10000000000010000001
10000001001000000101
10000100100100100001
1000100000000100N001
10010000001000000001
11000100000010000011
11111111111111111111
