NO test_artifacts/valid.xpm
SO test_artifacts/valid.xpm
WE test_artifacts/valid.xpm
EA test_artifacts/valid.xpm
F 37,91,54
C 235,25,3

11111111111111111111
10000000110000010001
10010000001000001001
10000000000010010001
10001000011100010001
11000010100000100001
11101001000111000001
11000011000100001001
10000001001100010101
10100000010010000001
100100N0000010110001
10000000000100000001
10010100001110010001
10000000101101100001
10000010000100010001
10000000000100000001
10000100000000010001
10000100100000101001
10001000000010110001
11111111111111111111
