NO test_artifacts/valid.xpm
SO test_artifacts/valid.xpm
WE test_artifacts/valid.xpm
EA test_artifacts/valid.xpm
F 194,107,3
C 146,43,65

11111111111111111111
10X000000	0000000001
10000X0N 0X000000 01
1 0000000 0X0X0   01
100X	00  00000	0X001
100	0 00000000000	01
10 00X0	00X 	0000001
100000 000 000X00001
10 	00000 0000000	 1
100	00X00000000000 1
1000XX000000X00X00 1
1X000X000 0000000 01
100X000000 000000001
10 0000X0 	0	00 00 1
100000000 X X0000001
100 0X000X00000X0001
100X 0	000000X000001
100  	0	00000XX0  X1
100000000	0000000001
11111111111111111111
