NO test_artifacts/valid.xpm
SO test_artifacts/valid.xpm
WE test_artifacts/valid.xpm
EA test_artifacts/valid.xpm
F 82,139,28
C 220,159,42

11111111111111111111
10000000001011010001
10010001001100010011
10100000000010000001
10000000000000001101
10010100110000000001
11010001100000000011
10000000101000N01101
11000001000000000101
10100001010000010001
10000010000001000011
10000101000000000001
10000011010000011011
10001100000000000011
10011101000010100001
10010011100100001001
10000000010110000001
10001010110000000001
10000010000001110011
11111111111111111111
