NO test_artifacts/valid.xpm
SO test_artifacts/valid.xpm
WE test_artifacts/valid.xpm
EA test_artifacts/valid.xpm
F 138,60,183
C 96,73,249

11111111111111111111
1	0X00 X0000X0X00001
1 0	000000000 0000X1
1X0X000	0 0000000001
1 X000000X00X00X0 01
1000000X0000000  0X1
1000 000000X00000001
1000000000000000XXX1
1000000 00000 X00001
1 00X000 0000000 001
10000X00000	 0 X00X1
10000	X 0000X0000  1
10	0 X00000000X 		01
10000000XX0000  0001
100000000N00X00000	1
100 0000000 0 000001
1000X0000000000XXX01
1000000		X 	X0	0 001
10	 0000000000000001
11111111111111111111
