NO test_artifacts/valid.xpm
SO test_artifacts/valid.xpm
WE test_artifacts/valid.xpm
EA test_artifacts/valid.xpm
F 59,59,25
C 42,90,219

11111111111111111111
11000001011000100001
10010101000000110001
10010011010000000001
111000100010N0101001
10000100110000000011
11000000000000000001
10000000100011000101
10100000101000000001
11010010000101011001
11000000010111100001
10110000000000000001
10010011000010100011
10010001010000000001
10000010000000000011
10010000000000010001
10000101001000000011
10011000000110000001
11110000000000000001
11111111111111111111
