NO test_artifacts/valid.xpm
SO test_artifacts/valid.xpm
WE test_artifacts/valid.xpm
EA test_artifacts/valid.xpm
F 118,161,91
C 8,65,136

11111111111111111111
100000000000 0000001
1000000X00X0000	0001
100	0000000X00000001
10	000000X00X00000X1
100X00000 X00X00 001
1000X00000000  00X01
10000000000	0000XX01
1X000X0 0	000 X0 001
100	0000000	0X000001
100000X000X0000 0001
10 0X000X00000000001
1000	00 000X000N0001
1 000000000X0000 001
10X0000000X000000 01
10	00000X0X0000000 1
10  0 00000000X0X001
10000	00XX0	 X0  001
10000X00 X00XX0000 1
11111111111111111111
