NO test_artifacts/valid.xpm
SO test_artifacts/valid.xpm
WE test_artifacts/valid.xpm
EA test_artifacts/valid.xpm
F 73,178,2
C 233,19,180

11111111111111111111
10000000001101101001
11000000100000110001
10100011000000000001
11000000010000000011
10000000000000000001
10000000100010000011
10111111000010000001
10001000100001100001
10000100000000010111
10000100010001100001
11100000100000000001
10010100010001001101
11000000000000000101
10100000001000000101
10010001001100011011
10000000000010001101
1000000N000000100001
10000100000001000001
11111111111111111111
