NO test_artifacts/valid.xpm
SO test_artifacts/valid.xpm
WE test_artifacts/valid.xpm
EA test_artifacts/valid.xpm
F 203,71,189
C 252,89,53

11111111111111111111
1 000 000 000 000001
10X0000  00000000001
100000N00X0  		 00	1
10000X0000	X00 	0001
1000  00X000 0000001
100 	00X00X	00000001
100X0000X0000000X0X1
10	 X00000  00X00001
1000 00	0	0000 0 001
1000000X00000X00X001
10000X0X0000	X00 001
1X0 X000X000 00X00 1
1	00000X 0X00000X X1
100  0XX00 00000 001
10X0000X X00000 00 1
10	0000000X 000	0	01
10 0X00000		00 000	1
1 0	0000	X0000000001
11111111111111111111
