NO test_artifacts/valid.xpm
SO test_artifacts/valid.xpm
WE test_artifacts/valid.xpm
EA test_artifacts/valid.xpm
F 58,62,105
C 229,130,45

11111111111111111111
100X00 0000000000X01
10000	0	000X 00 0001
1	0000000000 0 00001
1  000 0000 X0000001
1000000000000X0000	1
10X0000	X00000000 01
1000X0000000000000 1
1000X000000  00000	1
1000000	00 00 00X001
100000X0X0000000 0 1
1X X0X0	00000 000001
10000  0	0X00XX0	001
100000000 0 0X0000X1
1 0000 00000 0000	01
1 0X0000000000000X01
100X0	000000	0NX0001
1 00X00X 000000	0001
10000 0X00000000X001
11111111111111111111
