NO test_artifacts/valid.xpm
SO test_artifacts/valid.xpm
WE test_artifacts/valid.xpm
EA test_artifacts/valid.xpm
F 235,236,229
C 77,12,185

11111111111111111111
1000000	00 000	0X001
10	0000000X 0000X001
100X 000000	0	0000 1
1 000000X0X 00 0X 01
10	 0000000000000XX1
1 0 000 	00000  0X01
1000 0X000	0000	0001
1000	0	00 0000000001
1 000000	0000	00 001
1XX00X00000 0000 0 1
1	0X	0000000000 0001
10	0000000	00X0  001
1 00X	00 000000000X1
100X0 00000000X	00	1
10000000X0000 000	01
1000000000000X0X0001
1N0X00000000 X000X01
1X 0 00	0000X0000001
11111111111111111111
