NO test_artifacts/valid.xpm
SO test_artifacts/valid.xpm
WE test_artifacts/valid.xpm
EA test_artifacts/valid.xpm
F 171,,0,0
C 144,19,3

11111111111111111111
1000 0000 X 00X00001
1000000 000 0X000001
100		0 X000000 00001
100000000 X000000001
100X000000 000	00 01
100 		00000 XX0 0001
1	X00X00000000 X  X1
10 00000000 00000001
1000X	0XX0000  	0001
10000 00000000  0001
1 000 0X000000000001
1000000	0		0XX000001
100000	0000000000001
10  	0	0XX 0000	 001
1000000N0 0 0 000001
1	000000X0X0 0 00	01
1 000000 0X00XX000	1
10 X0000000X00	X0001
11111111111111111111
