NO test_artifacts/valid.xpm
SO test_artifacts/valid.xpm
WE test_artifacts/valid.xpm
EA test_artifacts/valid.xpm
F 176,131,141
C 103,174,200

11111111111111111111
1X00000	000000	X00	1
1000000000X000000001
10 0X00000 000000001
1000X 00000 0X 00001
1000 000000000X000X1
10 000	0 0000 0	0X01
10   00000X0	0000001
1000000000 000000001
100 0	000  N00 0	001
1X00 X00000000000001
100000000 XX0000 001
100000X0000000000X01
10000X 0X00X0X000001
1X0 0 0	000X00000001
10000	000X000000 001
1000000000X 00X0 0 1
100 0000X000X0 000X1
1	0 000 00000X0 0001
11111111111111111111
