NO test_artifacts/valid.xpm
SO test_artifacts/valid.xpm
WE test_artifacts/valid.xpm
EA test_artifacts/valid.xpm
F 1,198,166
C 101,134,92

11111111111111111111
10000	000000000 0 01
10X00 0 00000 000001
100000000000000	 001
100  X000	000 0000 1
1000000000000 000	01
10	X0	0X00 0X0000001
10	0 X000 000000X 01
10X00 000000000	0	01
1N000X0	000X 0000001
1XX00X0X00000X 0 001
10X0X00X0000000X0001
100X0 00000X0 0X0001
100X0 000X0X00XX0001
10X 0	000 XX0  	0001
1 00 0000000000000X1
100 0000	00000000001
100000000X00X00	0001
10000	00X	0 00000X01
11111111111111111111
