NO test_artifacts/valid.xpm
SO test_artifacts/valid.xpm
WE test_artifacts/valid.xpm
EA test_artifacts/valid.xpm
F 149,182,234
C 209,14,88

11111111111111111111
100 000000000X00 X01
1	0 00000X00	00000X1
100000000000 X000001
10  0000X0 000 	 001
100X 0000000X		 0001
1X00 00 00	00XX0X001
10000000000	00000001
10000 00	00X00000001
10X0	 000X0X0000	001
100   	0 0	0000X0001
10X000000X0 0000	001
1000  0	0000000 0001
1X0 0000X00000 000 1
1	000 00 0	X	0000 01
10000000	00XX 000	01
1000 000000 0X000001
10000X00000  N000001
10000000X0000X00 001
11111111111111111111
