NO test_artifacts/valid.xpm
SO test_artifacts/valid.xpm
WE test_artifacts/valid.xpm
EA test_artifacts/valid.xpm
F 152,184,164
C 41,137,74

11111111111111111111
10000000001001111001
10000001000001000001
10000000001010100101
11000000000000000001
10001000001000101101
10000000000100000101
11000000000100000101
10001001000001001001
10101000110100001001
11001000000101000011
1000010000010000N001
10000001010010000011
10001001000010101001
10100001000000010001
10100001000000101001
11000000000000100001
10110100000000110001
11000000001000000001
11111111111111111111
