NO test_artifacts/valid.xpm
SO test_artifacts/valid.xpm
WE test_artifacts/valid.xpm
EA test_artifacts/valid.xpm
F 64,14,4
C 92,138,122

11111111111111111111
10X0	00	0 0000XX0001
1  00000 000X 000001
10X0000000000000 001
1000	X0 N00X00000001
100000000000	00 0001
1 000	0	0000		00	001
1 0000000000000000X1
10XX00000000000000X1
1	00000X000X00000 X1
1X000000000  X 00X 1
10000000	0  X0000001
1000 000 0	000000001
100 000	 00000000 01
100000000000X0000001
10 	0	 0000000X00001
1000X00000000X0 0001
10	0 00 00000000X001
10000X	 0X 000000001
11111111111111111111
