NO test_artifacts/valid.xpm
SO test_artifacts/valid.xpm
WE test_artifacts/valid.xpm
EA test_artifacts/valid.xpm
F 124,167,14
C 47,171,125

11111111111111111111
100 000000  	00	0XX1
1X	X0000XXX000 	0	X1
1X0	0000X 	000	00001
1 0000000 X0X0000001
1 0000X000000X00	001
1X000X0000 	 0 000X1
10000000000XX00		0X1
1XX00000000  00000X1
1000 0 0 00X00000001
1000000 X00	0	00 001
1  0000000X000 X0001
10 00X0X000X00X00001
10000000 	000N0 0X01
100X00000XX	0X0	00 1
1000 X00 X00	0000001
1X00	0	00000	0X00XX1
10000X00000X0	000001
10000X0	0  00	0000	1
11111111111111111111
