NO test_artifacts/valid.xpm
SO test_artifacts/valid.xpm
WE test_artifacts/valid.xpm
EA test_artifacts/valid.xpm
F 13,0,0
C 28,127,156

11111111111111111111
100000 00 0X0000  X1
1X0000000X0X0000X001
10000000000000000001
1000 00 0X000X0000 1
10X0X0000000 0X00001
100N0000X0000	X00  1
1 X00X00 00000000001
1		 X00 000X0X0	0001
1000X X 00X 00 00001
10X000 0000000 0X0X1
10  X0X000000X00X001
1 000X000000000000X1
1000000X	000	0000001
1000	 0000000 000001
10XX0X0 00 00000	001
1 000	00000 X0000001
10 000000000X000 0X1
1000XX000X0000000001
11111111111111111111
