NO test_artifacts/valid.xpm
SO test_artifacts/valid.xpm
WE test_artifacts/valid.xpm
EA test_artifacts/valid.xpm
F 221,95,144
C 12,214,180

11111111111111111111
100XX00	0000000	0	01
10000X000000  000001
100000  000000000  1
100 0000	0 000N00001
10000 00 0	000000001
1000000 00000 0X0001
100X000	00X000000001
1X0000000	0XX	0000 1
1 0000000000000X0	X1
100X00000X000000	0X1
1	 0X0	0000	0000 0 1
1000 000000 000 0001
1X00X00	0XX0000000	1
1000 00000 000	000 1
10000  0000000	00 01
1X00	00 00000000	0X1
10000000 0	 00000001
10X00000  00X 000001
11111111111111111111
