NO test_artifacts/valid.xpm
SO test_artifacts/valid.xpm
WE test_artifacts/valid.xpm
EA test_artifacts/valid.xpm
F 110,0,0
C 136,133,215

11111111111111111111
100 00	000000 0 0001
10000000	 		0000 0 1
10 X0000 000 00X 0X1
100 00000000000XX001
1000	X	000  X0X 00X1
1000 000000X000X0001
10XX0000 X X000000 1
10000X0X 0000 000001
1000	00000 000000001
10X00000 0000000X001
1000 0000000000X0	X1
10	0000000000X000001
10000000 0000	XX0001
1X00X	00000000X	0001
1  00X 0000000000X01
100000000X0  0	000 1
1 	XNX0 0000X0 X0001
1000000X000000000001
11111111111111111111
