NO test_artifacts/valid.xpm
SO test_artifacts/valid.xpm
WE test_artifacts/valid.xpm
EA test_artifacts/valid.xpm
F 95,248,221
C 62,249,217

11111111111111111111
10000000000100010101
11001000010000100001
10100000000000000001
10000000001100101001
10010000110000000011
10000000010000000001
11100110110100110001
10111000100110011001
10000010000000100001
10000110000000100001
10000001010010010011
10101000011000000101
10000000101000010111
10011001001011000001
10000000100000000001
10010100000010000001
1010010010N000000001
10000100000000100011
11111111111111111111
