NO test_artifacts/valid.xpm
SO test_artifacts/valid.xpm
WE test_artifacts/valid.xpm
EA test_artifacts/valid.xpm
F 273,0,0
C 26,143,186

11111111111111111111
10000	0000 000000001
1 00000000000 XX00X1
10X00 0000 0000XX	 1
10  000000000		00 01
1X00 0000 0000000001
100000 00X	000000001
10 0X0 0000	X0000001
10X0 00000 000000001
10	  	X0000X0X0X0  1
1 00 0000X000XX00001
1	0X000X0	000 X0		01
100 0000000000	X00 1
1000X0 000X0N		0X 01
1000X 0X0	0000000 01
1 0 00000000X 0000	1
100000X0 00000000001
10	 X000 000000000X1
1000000000000 	00001
11111111111111111111
