NO test_artifacts/valid.xpm
SO test_artifacts/valid.xpm
WE test_artifacts/valid.xpm
EA test_artifacts/valid.xpm
F 119,47,206
C 232,100,141

11111111111111111111
11100001000000011001
11001000000000000001
11000100001000010101
10110000001000100001
10000000100001010001
10000110010000100001
10000000001010000001
10100000000011000001
10001000110001110001
10000000100000000011
11000000000010100001
11000001000100000001
11000000110000000001
10000000000N00000001
10000001000000000001
10000000010010000101
10000010000000000101
10010110111000000011
11111111111111111111
