NO test_artifacts/valid.xpm
SO test_artifacts/valid.xpm
WE test_artifacts/valid.xpm
EA test_artifacts/valid.xpm
F 171,0,0
C 53,247,130

11111111111111111111
10000X0X0000X00000 1
100000 0 0000X 00001
100000000000000 0001
1000	0 0X0 0 000N001
1X000000000000 00001
10000X000 0	0 00X001
1000X00		0 0	000 0	1
100000000X0000X 00X1
10 0	00000X0 000X001
100 00	00	000000 001
10		0000000X 0000001
10000	0 00000000X 01
100 0000X00000 00001
1000X00000X000000001
1000X000000 X0X00001
10000000 0XX000000X1
1000000000000000X001
1	00X000000X 0	0	001
11111111111111111111
