NO test_artifacts/valid.xpm
SO test_artifacts/valid.xpm
WE test_artifacts/valid.xpm
EA test_artifacts/valid.xpm
F 133,175,109
C 191,57,175

11111111111111111111
10000000X000000X0001
1X0 0 0XX0X000000001
100 000 000000000	01
1000000000XX00000001
1	00	0000000000NX001
1000000	000X00000001
10000X00 0X0000000 1
100 	X000 0X 00000 1
10000000000000X0X	01
1000000 0000X0000001
10X00 	X000X00X00 01
10X  00	000000000001
100000000	0X00000001
100000X00000000000	1
100000 0X0000	000001
1000 00 0 0000000XX1
1000X00000000 00	001
100 0 000 000		00001
11111111111111111111
