NO test_artifacts/valid.xpm
SO test_artifacts/valid.xpm
WE test_artifacts/valid.xpm
EA test_artifacts/valid.xpm
F 66,78,154
C 120,126,168

11111111111111111111
1X00 0 0  0X0000X001
10000000000000000001
10 000	X0000X00000X1
1	0X0 0 0  000000001
1000X000XX00000000X1
1 0000000XX0000000 1
10X00000000000 000X1
100N 0	00 0		0	000X1
10000X0 0000 00X0X01
100 	0X0000 0X0 	001
10000000 0 0	00000 1
100  000	00000000001
1X0	0000000X0000X0 1
100000 00000 0 0 001
100000X000X000000 01
1000 000000000000001
10X0   0X000 00	0001
100000XXXX00X0000001
11111111111111111111
