NO test_artifacts/valid.xpm
SO test_artifacts/valid.xpm
WE test_artifacts/valid.xpm
EA test_artifacts/valid.xpm
F 8,245,81
C 178,101,187

11111111111111111111
10000000000X 0	000 1
1000X00	000  0000001
1N00000000	000 00001
10X0000	00	00000 001
1 00000X0000000 00 1
1 000000000000	  0 1
10XXX00000000000X0X1
100 	00	 0 X00 00X01
1	000 00000X0 000X01
1 00X X000000XXX 001
10X000	00000 00X0001
10000	00	00X0000 X01
100 0000000 0X000001
1000000X0	0000000 X1
1 0000 000000000X 01
100 000X000	 0X00001
10X00000000X0X0 0001
10X0000X000 00000001
11111111111111111111
