NO test_artifacts/valid.xpm
SO test_artifacts/valid.xpm
WE test_artifacts/valid.xpm
EA test_artifacts/valid.xpm
F 84,69,143
C 192,14,53

11111111111111111111
100X	00	0X00	000	001
1XXX 0  X00 X0000001
100 0X000000X0 00X01
10X	0000X0000 X00001
100 000XXX0N0 0 0001
100X 00XX000000 X001
1X0	00000000X	0000	1
1000X0 000X0X 00 001
10000X00000 00000001
1 000000X000 X000001
100X0X00	0X0X 0X00	1
10 00	00X	00000X0X01
100000X000000X0X0001
100000X00X0000	00001
1X0XX000X   00000001
10	0000X 000 0000001
100XX0000 0000000001
100X000X0X00000  X01
11111111111111111111
