NO test_artifacts/valid.xpm
SO test_artifacts/valid.xpm
WE test_artifacts/valid.xpm
EA test_artifacts/valid.xpm
F 128,171,224
C 2,107,24

11111111111111111111
10101000011000000001
10000001100000000001
10000010001000000001
10000000000000000011
10000000011000001001
10000001001000000001
10000000000000001011
11011100000000100001
10000000110000000001
10011110001010010001
10111010100000010001
11100011000001000001
10000100001000010101
10111100000010010001
10000010010000001001
10000010000N00000001
11010001000000000001
10000000000100000001
11111111111111111111
