NO test_artifacts/valid.xpm
SO test_artifacts/valid.xpm
WE test_artifacts/valid.xpm
EA test_artifacts/valid.xpm
F 87,205,175
C 137,75,15

11111111111111111111
10000X000  00X0000X1
100X0 00	000 0000001
10	00000 X	0000  001
100000000 X00NXXX001
10 0 0000000000	0001
1000X00000000	00X001
10	0X0000000X0000001
10000 00000	000000 1
1 000 X000000000X001
1000000	0X0	0	 000 1
1X0000 00000XX000001
10X00000 0X0000X0001
1000 0000X0  0000001
1X0 00	0000 0X000001
1000000 X00		X 00001
10X 0X	0	000000	0001
1	X0000000000 0000X1
100XX0000 0000000X01
11111111111111111111
