NO test_artifacts/valid.xpm
SO test_artifacts/valid.xpm
WE test_artifacts/valid.xpm
EA test_artifacts/valid.xpm
F 169,,0,0
C 1,162,173

11111111111111111111
10X00X000 0X0X0XX0X1
1X0X 00000	000X000 1
10000000 000	  00 01
10000000X00000X00001
10000000XX 00X0000X1
10 000 X00000	0X0001
100000000X0 0	X00 X1
10000000000000000001
1X00X 00  0000X 0001
10000X0 00 X	00 0001
1 0000	 00	0 0X 00X1
10 	0X00X 0 X0000X	1
10	00 00000000	00X01
10 00	0XX0	000 0	001
10X X000000  000  01
10 00000 	00 0000001
10 00X0X 0   00 0	 1
1 000 00000000N0  01
11111111111111111111
