NO test_artifacts/valid.xpm
SO test_artifacts/valid.xpm
WE test_artifacts/valid.xpm
EA test_artifacts/valid.xpm
F 30,249,255
C 49,184,142

11111111111111111111
10000 0X000000X 00 1
10 0 	0000X00000X001
10X 	00  00000XX0001
1	00X0000	0000000001
1X00000 000000	 XX01
10000X000000000 00 1
1X0000000000X0X00001
1 00X000 000000 0001
100000000000 0000	01
10000000000000X000X1
10 0	00000 000000001
100 000 00000XX0X001
10X000X00000X 0 00	1
1 000 	0 XN	0000	001
10X00000000 00	000 1
10X0000000 0	0 000	1
1X0000000	0	0  00  1
10 000	X000000X0X001
11111111111111111111
