NO test_artifacts/valid.xpm
SO test_artifacts/valid.xpm
WE test_artifacts/valid.xpm
EA test_artifacts/valid.xpm
F 59,25,235
C 148,248,64

11111111111111111111
10000000010000110011
11010001010001001001
10100100010000100101
10000111000001110001
10001000000000001101
10001010100000000001
1000110101000N000111
10100000000000000001
10000010010010100001
11000101000000001011
10000100010000101011
10000101010001110001
10000000000100000001
10100000000100000001
10010100001001000001
11000001000000000101
10011100100001010001
10001101100000010011
11111111111111111111
