NO test_artifacts/valid.xpm
SO test_artifacts/valid.xpm
WE test_artifacts/valid.xpm
EA test_artifacts/valid.xpm
F 221,26,43
C 210,146,91

11111111111111111111
100  00000X00X0  0	1
10	0X00X0000000000X1
1X0 0000 00000000001
100000000	0000	00001
1000XX000 00 00X0001
1 00000 000000000001
10000000		0000000001
1X00XX0	000000	0X001
10000000 0 0X0000001
100	0000 X0000000001
1	000000000 00000X01
10000000	 00X 000001
100X000 000		0000001
1000000000 X0X00 001
100 X000	000X00000 1
1X0 0000N000 000	001
100  00X00  0000 	01
1000000000X00  00001
11111111111111111111
