NO test_artifacts/valid.xpm
SO test_artifacts/valid.xpm
WE test_artifacts/valid.xpm
EA test_artifacts/valid.xpm
F 96,234,11
C 95,196,90

11111111111111111111
100X0 	 0XN 00000		1
10000 00000X00000 01
1000000000000	0000X1
100X00	0X0	000000001
10000000X00000000001
1X0	X 0X	00 00 00001
10000000X000000X 001
1 X0X0000X0000X0	001
1000000 00X000000001
1000XX000 0	000XX0	1
100000X00X	X	0000001
100X0X 0X00000000001
10X0X0000000000000	1
1000000X 000	00X0X01
100X000000 0 00	0001
1000X0 000000X0 0001
10X0 	0000X0000	X001
10000 X000	00		00 X1
11111111111111111111
