NO test_artifacts/valid.xpm
SO test_artifacts/valid.xpm
WE test_artifacts/valid.xpm
EA test_artifacts/valid.xpm
F 135,,0,0
C 160,191,16

11111111111111111111
10	00000000X00000001
10000 0 00 XX0000001
1000 X0000000 00X  1
10000 	X000000 X00X1
1000  00 00X 0 000	1
1X0000000 0000000001
10000	000000X0000X01
1000XX000	000 000001
10000X0 X000X0 X0X01
1	00NX0	000	000XX001
10000000000 000X0001
100000X 00000X000001
100	 00000  00XX0001
1000000000	0X00	XX01
10   0 0		000	000001
100000X0  00 0000001
1	XXX00  00000 0X001
10000000000	X00 0001
11111111111111111111
