NO test_artifacts/valid.xpm
SO test_artifacts/valid.xpm
WE test_artifacts/valid.xpm
EA test_artifacts/valid.xpm
F 229,75,213
C 202,182,68

11111111111111111111
10100000000000000111
10000000N01001000101
10000000001000000001
10000101100000100001
10000000000000000011
10000100000000100001
10001001000000010011
10100000000010000001
10000001000000000101
10000100010000000001
10010000000001000001
11000000010000101001
11100000010000000011
10010000100000101011
10000001010000001001
11010001000000001011
10000000010010100101
11100110000000000011
11111111111111111111
