NO test_artifacts/valid.xpm
SO test_artifacts/valid.xpm
WE test_artifacts/valid.xpm
EA test_artifacts/valid.xpm
F 126,159,117
C 10,69,191

11111111111111111111
1000X00X000000 X0001
1X0	000XXX0 00  0001
10X00X000 0X00000001
10 000X0000X0X 00001
10X000N00	00X0000001
1000000000 000 000X1
100X000 00 000000001
10000X000 00	00000X1
10	0 0 000X 000X0X01
1000X	000000 0 X 001
10 00    00000 000 1
1000000000	0X00000 1
100XX0	0 00000	0  01
10 000 000 0X0 00001
1 XX00000000000X	001
1	0000000000	0X000X1
1000		 0000X00 0X001
100X00 000X0	0 000X1
11111111111111111111
