NO test_artifacts/valid.xpm
SO test_artifacts/valid.xpm
WE test_artifacts/valid.xpm
EA test_artifacts/valid.xpm
F 69,83,230
C 213,213,35

11111111111111111111
100 0000000000000N 1
100000 0 X000000 001
1000000	0X000X0	0X	1
100	00  0X0000 	00X1
1000X0000000 0000	01
1000	00 0 0000000001
10X 0000000000000001
1 0000	000	 00XX0001
100X0000000000000 01
10X0000X0000  	00 01
10000X0 X000X 0000 1
10000000 0000000X0 1
10	00 00000000000001
10 	0 0000 00X00X001
1 00 000	00X00000001
10	000000000 00X0001
1XX000X00000000 0001
100 00 0000000	00001
11111111111111111111
