NO test_artifacts/valid.xpm
SO test_artifacts/valid.xpm
WE test_artifacts/valid.xpm
EA test_artifacts/valid.xpm
F 149,193,1
C 99,23,34

11111111111111111111
10 0  0000X00  000 1
10  	0XX00000	000X01
100	0000000X00  0001
1000X0   000	0000 01
1000000000X0000 0  1
1000000000XX00 000	1
100000XX0X 0000000X1
1000	0X000	00 00  01
1X0  0000X00 0000001
1000N000000000000001
1 000	 000 0000X X01
100000	00X00	00X0XX1
1000000000000000 001
1000X 0000000000 X01
1  0 00   XXX00X00	1
10 0000 X000X00   X1
10X00000 0X000000 01
1X00000	000000X000 1
11111111111111111111
