NO test_artifacts/valid.xpm
SO test_artifacts/valid.xpm
WE test_artifacts/valid.xpm
EA test_artifacts/valid.xpm
F 53,101,231
C 108,26,255

11111111111111111111
1000  000	0X000 0001
100000000X0	 0000001
100X0 X000X0000 00	1
100000 00X0000	00001
1X0 00X00 00 00X00X1
100X X00	0000	00 001
10000	000X0XX0000 01
10	0XX	000000X000 01
1  00000	 000 000X01
100000 	X000  X0XX 1
1 000 00X0000X000001
1	0 XX X0X 0X	000X01
1X00 00000X	0000 X01
1X000	00000	0	 0 001
1 00000000000 00X001
1 0X	000N 0X00 00001
1	0 	000000 X 000 01
100000 0X 00	 000	 1
11111111111111111111
