NO test_artifacts/valid.xpm
SO test_artifacts/valid.xpm
WE test_artifacts/valid.xpm
EA test_artifacts/valid.xpm
F 255,73,29
C 80,247,23

11111111111111111111
11001000100100000101
10010010000001000101
10000110010010101101
10000100110001100001
11000100001000010111
1100010N000000000001
10000000010110000011
10000000010001000001
10001001101000010101
10000000000010110101
10000000000000000001
10000000000000000001
10101110000000000001
10010100010000101111
10001000000000000101
10010010001001000011
11000100001010000001
10000000001000000001
11111111111111111111
