NO test_artifacts/valid.xpm
SO test_artifacts/valid.xpm
WE test_artifacts/valid.xpm
EA test_artifacts/valid.xpm
F 97,220,213
C 100,173,12

11111111111111111111
10000000 00000000001
10000000N0000000X0X1
10000X000  000000X01
100000 0000X0000X001
1X0000   0 00	 	0X01
10X0  0 X0	 00X	0  1
100X00 0   0000	X001
1000 000	 	000X 0001
100X0000 000 X000001
100	X000000X00	X X01
10	00  0	00X  00X001
10X00000 00000	 0001
100 X000X 0000000001
10  00000X00X  00001
1000000X00	X0 XXX001
100 00 00 000		00001
1000X	0X00X0 0 X0001
1	0000 0	0000  00001
11111111111111111111
