NO test_artifacts/valid.xpm
SO test_artifacts/valid.xpm
WE test_artifacts/valid.xpm
EA test_artifacts/valid.xpm
F 83,77,103
C 41,66,93

11111111111111111111
11000000001000001011
1000000000000N000011
10000100001000000001
10001001000000000001
11000000000001000011
10000000000000000001
10010000100000000001
10010001000000001001
10011000000100000001
10000100100000000101
10000010010010000001
10001000001000100101
11000010000001100101
10000100000000000001
10000011001000000001
10000010100100000101
10000000001001000001
10000000010000000011
11111111111111111111
