NO test_artifacts/valid.xpm
SO test_artifacts/valid.xpm
WE test_artifacts/valid.xpm
EA test_artifacts/valid.xpm
F 9,,0,0
C 147,121,26

11111111111111111111
10000000 000000 0001
1000000000		00 00001
100	X00000	X00X	0	01
10XX0X0000	00X0	0XX1
100 00	0 0X0 0000001
10000X000000000000 1
10000 00X0X0X000X0	1
1X00	00000	0000X00X1
10	0000000000 000 01
10 0 X0 X00X 0X00001
100 0 0000000 000001
1000000000000 00X 01
10X00000 000X0X00001
10000 0000 00		X	0X1
1X00XX00000X  	00001
1 0000000	X000000001
10X00000  00N 000001
100X0000 0 000000001
11111111111111111111
