NO test_artifacts/valid.xpm
SO test_artifacts/valid.xpm
WE test_artifacts/valid.xpm
EA test_artifacts/valid.xpm
F 51,124,77
C 110,247,94

11111111111111111111
10	00000 X000 	X0001
10000000000 000 X001
1 00 0000000000	0001
1000X 00 00000	X0001
10000000X0000X000001
1	0 000X	XX000000001
100000000	00	 X00X01
100000	000000000 001
10000	00000000000001
10000X 0 000000000 1
1000000  000 00 0 01
1X	00  X0000X	X0X001
1X0 00 X0000X000	001
10000  	   00 0 00 1
100	000000  X0	000 1
10X0000X	00X00000001
10000000X0000000X 01
100	000X 000N	000001
11111111111111111111
