NO test_artifacts/valid.xpm
SO test_artifacts/valid.xpm
WE test_artifacts/valid.xpm
EA test_artifacts/valid.xpm
F 178,221,16
C 109,232,204

11111111111111111111
1X00000000 000XX0	01
100000  0000X 000001
10000X00	0 000000001
10 0X0000000X0X 0X	1
100000 00 00000X0 X1
10000000X0	 X0000001
10000000000 00000X01
1000 000	0000 X0X0X1
10	00X0	0000	0000 01
100000X00000000000X1
100 000 X000XX0000 1
100000X0000000X0	0X1
1 000000000X0000	0 1
1000	00 0X000	0000	1
1	000000N00	X	00 001
10000000X000000000 1
1000000000 0 0XX00 1
10X0X00 	00000000001
11111111111111111111
