NO test_artifacts/valid.xpm
SO test_artifacts/valid.xpm
WE test_artifacts/valid.xpm
EA test_artifacts/valid.xpm
F 10,,0,0
C 142,236,247

11111111111111111111
1 00		0000000 	0 001
100 00000000	X00 001
1000000000X 00000001
1X000	000000000	 0	1
10 0X 00 00000000001
1	000X0 00 	0   0001
1X00 000 X000	0	0  1
1000	XX0 0XX00	00 01
100000000 0 000 0001
10X00000 0	000000001
1X00X  00 X0	00 0 01
10X00	000	0X00X00001
10	 	 0000 N00000X01
100	00 0000000000001
1000X000000000X00001
10000000XXX000 00001
1 0000000000000X0 01
1X000 0X000	X0000001
11111111111111111111
