NO test_artifacts/valid.xpm
SO test_artifacts/valid.xpm
WE test_artifacts/valid.xpm
EA test_artifacts/valid.xpm
F 131,,0,0
C 168,10,123

11111111111111111111
1 0000 0	X0X00000	01
100000000X00 000 001
1000000	00000	000001
1000000	X00	X0000001
1000000XX00X0000	001
100X 00000000000X001
10000000000000000X01
1000 00	0	000X00X0	1
1000X0X 00X0 0000001
100X00 00XX00X000001
100000000  00	XX0X01
100      	0 X   0  1
1X	X0000	00X0X	0		 1
10000X 00 	0X0X00 01
1	X0X00000 0	0000001
10X000X000	0	0N00001
1000000 0000 0X00001
1000X0 00000  000001
11111111111111111111
