NO test_artifacts/valid.xpm
SO test_artifacts/valid.xpm
WE test_artifacts/valid.xpm
EA test_artifacts/valid.xpm
F 154,33,37
C 9,59,120

11111111111111111111
1000 000000 00 X	X01
100X	0000X00000000X1
1000000X0 00	X0000X1
1000000X000 0 X	0001
100000 0000	0000 X01
100000	000X0X0X00001
10  000000 0000  0 1
100000000X0000000001
1000X000 00XX 00 X01
100 0000000000XXX001
10000X00	X 000000001
10	00000000 00000 01
10000 000X00 000	001
1X0000000000000	0	01
100000X0000000000001
1000 X000000 0000001
10X000 X 0000 00XXN1
1XX	000 	0	X000000X1
11111111111111111111
