NO test_artifacts/valid.xpm
SO test_artifacts/valid.xpm
WE test_artifacts/valid.xpm
EA test_artifacts/valid.xpm
F 145,154,220
C 121,75,219

11111111111111111111
10110001010010001001
10100000001001000001
10100000000010000011
10000001000100000011
11000001000000010011
10000000000000000001
100010000010N0000011
10000000000000010001
10000001000011000001
11000000100000010001
11000000000010000111
10110000010000110001
10000110000000000011
10000000010000011001
10010010000000010011
10010000000100001001
11001000000010100001
10010000000100000001
11111111111111111111
