NO test_artifacts/valid.xpm
SO test_artifacts/valid.xpm
WE test_artifacts/valid.xpm
EA test_artifacts/valid.xpm
F 121,252,254
C 94,254,4

11111111111111111111
10X0 0000000 0000001
10000000 0	00 000001
10000000000	0	 000	1
10000	00X00	000X0001
10 0	X0 0	000X00	0X1
1	0 000X0XXXX 000 01
1000 000 000000000 1
10000000000X  0X0X01
1000X 0000 0000 0 01
10 0 0000N 0000	 0 1
1000 0000000	0	 0001
100000 0000000000X01
1X00000 0 0	00X000	1
1X000000000000000	01
100000000X0000000 X1
10000X00000X 00000X1
10	0000000000X 000 1
10 0	000000 0		XX0	1
11111111111111111111
