NO test_artifacts/valid.xpm
SO test_artifacts/valid.xpm
WE test_artifacts/valid.xpm
EA test_artifacts/valid.xpm
F 16,80,159
C 3,223,232

11111111111111111111
10000100010000011001
10000010000000000001
10000100001000001001
11001000010001001001
10011000000000000011
10001000010000000001
10001100000000000001
10010000001000001001
10000000000000000001
100010000N0100000001
10001100000010000001
10010110000000000011
10000110000001000011
10100000000001010011
10000000000010000001
11011000000001001001
10000010001000010101
10001000000101000001
11111111111111111111
