NO test_artifacts/valid.xpm
SO test_artifacts/valid.xpm
WE test_artifacts/valid.xpm
EA test_artifacts/valid.xpm
F 164,235,53
C 139,26,132

11111111111111111111
100000000 00X0 0X001
100	00000 00 0000001
1X000	000 00000X0001
10000 00000000	0 0	1
100000X000 0X0000001
1 0 00000X00000 0001
100000X000000X000001
1000X0X000 	000000X1
100 00 00  0 00X0001
100 0X00	 000000	0	1
10XX 	000000 0X0 001
10X000000X 0   0	0 1
1 00000X00000 X00 01
10000000 0000	00 0 1
1	00	00	0 X 	 000001
100X00000000 	000001
1  000000	0000000001
1000000000000000NX01
11111111111111111111
