NO test_artifacts/valid.xpm
SO test_artifacts/valid.xpm
WE test_artifacts/valid.xpm
EA test_artifacts/valid.xpm
F 19,104,29
C 56,232,95

11111111111111111111
1 0000	000 000000001
10X0 00X0 X0X0000	01
10XX0X0	00X000000001
10000000X	00  N000X1
1	00	X00X0 00  0X001
1000000X000000  0X01
1 00000 000X000000 1
1000 00000X00	000001
10X0X00X0	000	0000X1
100 	00 0000	0X00001
1	00000X0	00	000X X1
10 0X0000 0 00000001
1X000000000000000 01
1X00000000 0000 X001
1000 	000000	0000001
10 000	0000X000000	1
1000000	0	0000X0X001
100000X0000X 0000001
11111111111111111111
