NO test_artifacts/valid.xpm
SO test_artifacts/valid.xpm
WE test_artifacts/valid.xpm
EA test_artifacts/valid.xpm
F 243,118,189
C 39,231,156

11111111111111111111
10000000000100000011
11100100000110000001
1000000000000110N001
10101010000101000001
10000100001010010101
10010101000000000001
10000000101000010001
10011000110000010011
11100100010000110011
10000000000000000001
10000001000000010001
10010010000010010001
10000000100000100001
11000000000011000101
10000000100001000001
10000011000010000001
10000000001000000001
10010000010000100001
11111111111111111111
