NO test_artifacts/valid.xpm
SO test_artifacts/valid.xpm
WE test_artifacts/valid.xpm
EA test_artifacts/valid.xpm
F 126,53,191
C 236,60,82

11111111111111111111
10000000000000100001
11110000000000010101
10001000000000000001
10100000000001011001
10000110010000000001
10000000000100000001
10100100000010001001
10000010000101010011
10000000010000001001
10000000001000000011
10000000000000101101
1000N000001000111001
10000000000010000001
10000000101000000001
11000010010010011011
10000000011100000101
10000101000000000101
10111000110000000001
11111111111111111111
