NO test_artifacts/valid.xpm
SO test_artifacts/valid.xpm
WE test_artifacts/valid.xpm
EA test_artifacts/valid.xpm
F 189,5,167
C 57,130,199

11111111111111111111
100000 0000000000001
10X00000  0000000001
1	000  000000 X00001
1 00000X000000000 X1
10 00X000000 0000001
1X00X000X0 0	 00  01
1	 000000	00 00  0X1
10000000000XN0	00001
10 0 00000000	X00X01
1000  000000	X000001
1X 	000X0000 0000001
1000000 	0X000000001
1 0  000	000	0000001
1	X0  0 X00000X00001
1000 00 X00000	X0 	1
10000000000000 00001
1000 0000	00000X0001
1X00  000	X	000 00X1
11111111111111111111
