NO test_artifacts/valid.xpm
SO test_artifacts/valid.xpm
WE test_artifacts/valid.xpm
EA test_artifacts/valid.xpm
F 119,57,213
C 198,144,232

11111111111111111111
100000		00 000X0 X 1
100000000000000 0001
10X 0X000000000X0X01
10000	000000000 0X01
1	00000X0	0	00000001
10000000	000 X000001
100000000000 0000001
10000X X0X000X00	X01
1000XX   00000000001
10	000 000000000X001
1000000X	00000000001
10 X000 0	0000NX0001
1XX00 000000XX0	0001
1000XX00000 	00 0	 1
100	0X00 	0X00 0	001
100	000  0X0X0	00001
100X 00000000000	001
10000000000X 00	0001
11111111111111111111
