NO test_artifacts/valid.xpm
SO test_artifacts/valid.xpm
WE test_artifacts/valid.xpm
EA test_artifacts/valid.xpm
F 120,70,62
C 103,122,12

11111111111111111111
100	000000 00	X00001
1  000000 0	00000001
10000000X0 00X000001
100000000000X000 001
1 0 000000000000  01
100X0	000X00000 0 01
100X00000	00000 0X 1
1 		0X00000000000001
100000X	00 000 000 1
10 0 0000X		000	 001
10   X0	00X00 X0X0X1
10	 000X00000 00 001
100N 	0  00	000000	1
1X00000	0000X	 00X	1
1000X 0X00000000	001
1	00000 00X0X 	00001
100 0X0000 00	X00001
1X 0000000X0 0000001
11111111111111111111
