NO test_artifacts/valid.xpm
SO test_artifacts/valid.xpm
WE test_artifacts/valid.xpm
EA test_artifacts/valid.xpm
F 22,0,0
C 35,167,216

11111111111111111111
100X0000 000000000 1
1	000000000000 00001
10X	0000XX00000  001
1    00X00X0	000X001
100X00X0000X0	N000X1
100	0X0X000000000001
1 0X0000000X00 00XX1
10000 0X000000000001
1000 0	0	00000 00001
1	00 000000XX0000001
1 000000	000X0 00001
10000	00 0	0	0000001
10 000000X000X  0 01
1000000000000 X00X01
1X0 0X	0000X000 0001
10000000000 0 0 0001
100	0000 000 0000001
10X 000 00 0000	0X01
11111111111111111111
