NO test_artifacts/valid.xpm
SO test_artifacts/valid.xpm
WE test_artifacts/valid.xpm
EA test_artifacts/valid.xpm
F 119,227,29
C 196,228,255

11111111111111111111
10001011001000000001
10010001000000000001
1000000000000000N011
10000100010000000001
10010000001010010101
11000011000110001111
11010000000000000011
11010001000000000001
11000001011100100001
10001000000000011001
10100000000010000111
10100001001000100001
11000000000000000001
10010110000000000001
10000000111100110011
11000110001000100001
10000000010001100001
10000110000000000001
11111111111111111111
