NO test_artifacts/valid.xpm
SO test_artifacts/valid.xpm
WE test_artifacts/valid.xpm
EA test_artifacts/valid.xpm
F 20,84,40
C 91,227,31

11111111111111111111
10011000110000100001
10000000110100100001
11000001100100000001
11100000000100000111
10000010000001000001
10N01001000000001001
10000101100001000101
10001000000000000011
11001010000000011001
10000000010000000011
10010000000000000001
10000000100011000001
10000001010000000011
11000000000000110101
11000001100100100001
10100001010000000011
10000011101000000101
10001000010000110011
11111111111111111111
