NO test_artifacts/valid.xpm
SO test_artifacts/valid.xpm
WE test_artifacts/valid.xpm
EA test_artifacts/valid.xpm
F 178,158,12
C 74,78,240

11111111111111111111
10 00 00X0X0X00		001
1000000 0000000X 001
10X000 0 000	X	00001
10X0 0X00X0 00000001
100000	00000X0N000 1
1X00 000000000000001
1X00	000	X00X00000 1
100000000X00X00X00X1
10000000XX0 	0 00001
10000000 00	 00X 	01
100000000 00000000 1
10000 000X 00X000001
1X0X 0	00 000 0000	1
100 0000 000000000 1
100 00	0 000X000 001
100000X0		0X000X0001
1000X00X0000000000	1
1X00000000X0XX000 01
11111111111111111111
