NO test_artifacts/valid.xpm
SO test_artifacts/valid.xpm
WE test_artifacts/valid.xpm
EA test_artifacts/valid.xpm
F 213,24,20
C 78,76,7

11111111111111111111
1000000	000 00 X0001
100000 	X00000000 01
1X00000000	X00 00X01
1000000000 N 0000 01
100X000X0 00000000X1
1X00X0	X0000000X0001
10000000	000000 0 01
1000000X000 00000001
1000000X0 	0 X	 	001
10 00000X00000 000X1
100X000	0X00000 	0 1
100	0 000000000 0 01
100000000000X0 000	1
1X 0	00X00000 00 001
1000000	00X000 00001
100X00X00000000000X1
1X0	00X	0000 000   1
1X00000 000 00000001
11111111111111111111
