NO test_artifacts/valid.xpm
SO test_artifacts/valid.xpm
WE test_artifacts/valid.xpm
EA test_artifacts/valid.xpm
F 135,90,253
C 106,149,122

11111111111111111111
10010000000001110001
10100000100000010001
10000000000100001111
11000000111000000001
10000000010010010001
10000110100010011111
10N00000000000011001
10001000001110100001
10010000000000000011
11000100000001100001
10000001001010010011
11000010100000100001
10000001000000000011
10010010000101000011
10001001100101010001
11000000000110100011
10000110101000000001
11001001000100010001
11111111111111111111
