NO test_artifacts/valid.xpm
SO test_artifacts/valid.xpm
WE test_artifacts/valid.xpm
EA test_artifacts/valid.xpm
F 176,,0,0
C 0,32,11

11111111111111111111
1000000000X X0000001
100000000000000000	1
100000 000   00X00X1
1 0	 0X 00 000000X01
1X   0X000XXX00 00	1
100000000 00 0	00001
100XN 00	00000000X01
10000000000000 0 0 1
1000 000 0000 XX 0X1
100000000X00 0000X01
100000000X0X0X0000	1
1  0000 0  00X00	001
1	00	00000X000000001
1X0	0XX000	0 00000	1
10 0  000000X00	0001
10 0X000X 0000 00	X1
10X X	0 00	  0 00001
1000	00	0000 0000001
11111111111111111111
