NO test_artifacts/valid.xpm
SO test_artifacts/valid.xpm
WE test_artifacts/valid.xpm
EA test_artifacts/valid.xpm
F 48,236,56
C 113,154,247

11111111111111111111
10000 0		000000	0001
1X0 00X0X	0X00X00 X1
1X000000000X00000	01
1XX000X00 0X00000X01
100XX0	00X0000000001
10	0000000000000X001
10 000000000 000	X01
1000000X0000X0 000	1
1XX000X0XN 000	00001
1 00 0X000 00X000001
1	000X00	0X000000001
100000000000X0	000X1
10	00000000000	00001
100000XXX00	  0 0001
100 00 00X000  0 001
100X	0 00000	0000001
10000 0000000 0 00X1
1X	0 0000000X0000001
11111111111111111111
