NO test_artifacts/valid.xpm
SO test_artifacts/valid.xpm
WE test_artifacts/valid.xpm
EA test_artifacts/valid.xpm
F 209,154,62
C 13,74,41

11111111111111111111
1X000000 00000000001
10	 000 00000X000 01
1000X0000000000 0001
1000X 00000	000 0001
1	X00000000000000001
100 00000000X0000001
1000XX00	00X 0000	01
1000000000000 	00001
100000000X00X 00 001
100000000000000000 1
10 0000 00XX00000001
1X0	  0000 0 0000001
10000000X00	00000001
100 0000 00	X0000X01
1	00XX000000 0X000 1
10  00 0 000000 0001
1000 XX00 00 00 0001
100 N0X0 0000000X0X1
11111111111111111111
