NO test_artifacts/valid.xpm
SO test_artifacts/valid.xpm
WE test_artifacts/valid.xpm
EA test_artifacts/valid.xpm
F 10,179,204
C 190,39,146

11111111111111111111
100X0000 00000000001
1000000000 	0 000 01
1X0 0X00000000000001
1000 0X00000	00 X001
10 X0X00000000000001
100000000000000X00	1
1000000000X 00X 	001
10 000000	X000	0	001
1000X0 00 00	0XX0 01
10 0	000 00	000 	X01
100X0X000	X000N0 001
10X000X0X00 0X 00001
10	0X 0X000000000X01
10X000 000 0000 X001
1000000000 	00000001
1	00X00000000 00	0X1
10000	000X 00 0000X1
10X00000 0X000000001
11111111111111111111
