NO test_artifacts/valid.xpm
SO test_artifacts/valid.xpm
WE test_artifacts/valid.xpm
EA test_artifacts/valid.xpm
F 148,148,203
C 179,223,221

11111111111111111111
10100000000010010011
10010000101000001011
10000000000000000001
10100100000010001101
10100010000001100101
11000000000100010001
11000100000010001001
11110010100000000011
1000000000N000000011
10000000000010001001
10100000001000000101
10000100000100000111
10010000000000000111
10010000011000001101
10000001001010010011
10001001000000010001
10010000010000000011
10001000100100011001
11111111111111111111
