NO test_artifacts/valid.xpm
SO test_artifacts/valid.xpm
WE test_artifacts/valid.xpm
EA test_artifacts/valid.xpm
F 18,4,88
C 39,240,197

11111111111111111111
10 0 000 000X0000 01
100X00 00 0	00000001
1000X000 000	00 0001
1000000	X000 0 00X 1
100000000000000000 1
1000X000 00000000  1
1000	000	0000 00X001
1 000000X00 00 00X01
100X0  0000X  	0 0 1
1000XX0 00000 000001
100000X0000000	00001
10 00000000XXN000	X1
100 0000 000000X	001
100000000000000   X1
1X000000 0000X000001
1 0000 	000 00000001
100 0X0 000000X0X001
10X000000000000000X1
11111111111111111111
