NO test_artifacts/valid.xpm
SO test_artifacts/valid.xpm
WE test_artifacts/valid.xpm
EA test_artifacts/valid.xpm
F 71,25,109
C 46,204,75

11111111111111111111
10000 X00000 0000	01
100000 0	 00X0000X01
10X00 00000X0 000001
100X0000 000 0000 01
1X000000000000	X0001
10N0X000000000000001
1XX00	0X0X000		00001
1 000000000	0	000001
100X 00X	0 0000000 1
100000 0 000000XX001
1000	0	 0000000 0X01
10000 XX00X0		0X 001
10 0 0	0000000000	X1
1 0000000000 0000001
1	000000000000 000	1
10000000X X0 0000001
1X000 0	000 0000X0	1
1000000 00 0000000 1
11111111111111111111
