NO test_artifacts/valid.xpm
SO test_artifacts/valid.xpm
WE test_artifacts/valid.xpm
EA test_artifacts/valid.xpm
F 74,104,175
C 119,25,171

11111111111111111111
10  00 00 00000000 1
1 00X00000 000000X01
1 000X00000000000001
10000000000000000001
1X 0X000000 00000001
1X 00XN00X	0000	0001
100X X00X0 0000000 1
100X	00000000000 	01
100X0 	00 X00 0	00X1
10 	X	00000000000X 1
100	 000	00	 X000 01
100000000	0000	00 01
1	0X 0000	00	 	00	 1
10000000 000X0X00X01
10	000	 00X0X0000001
100000	0	00X00X00001
1000 0000X000XX0	001
10X00000	000	 000001
11111111111111111111
