NO test_artifacts/valid.xpm
SO test_artifacts/valid.xpm
WE test_artifacts/valid.xpm
EA test_artifacts/valid.xpm
F 23,0,0
C 140,180,228

11111111111111111111
1000X0 00000	000 0 1
10 0 XX00NX000X00001
1000 000000X00000001
10X00XX0X00000000001
10X00 00000000000001
100 0 X000000000 0	1
1	0X00 00 00 000X0X1
100000000  0X00 X001
1X000000	000000000 1
1X0	X00X00000	000001
1 000000000000000001
10000000000000XX00X1
1X00000000000000X  1
100000000XX0000X00 1
100000000	000	X00001
100000000 0X000000X1
1000X000 00000000001
1XX00X00000X000X0001
11111111111111111111
