NO test_artifacts/valid.xpm
SO test_artifacts/valid.xpm
WE test_artifacts/valid.xpm
EA test_artifacts/valid.xpm
F 137,14,167
C 130,136,170

11111111111111111111
11000000000000000111
10000001000000000011
11001010000000000001
11100000001010000001
10110001100001000001
10000100000000011101
10010000100000000001
11011010000000001101
11010000001100000001
11110000010000110111
10000001010011001001
10100000000001100001
1000100N000000010101
11000000010000000001
11000100000001010001
11000001001000011011
10100000000000000001
10100000000111000001
11111111111111111111
