NO test_artifacts/valid.xpm
SO test_artifacts/valid.xpm
WE test_artifacts/valid.xpm
EA test_artifacts/valid.xpm
F 57,,0,0
C 119,112,221

11111111111111111111
10000X000000  00	 01
1000000X000 000000	1
1X00000	 00000000001
10X00 000000	0000	01
100X0000000000000	01
10000	00000000 0 	01
1 	X0 	000XX00000001
100 000	000X   X0 01
1000000000000000 001
10	0	00000  0000 0 1
100X000000X000 00001
1000X00 0000X0000	01
10000000000000000001
100X000	N00 00000001
1  000000XX00X00X0 1
1X00000 X00 000 0001
1X	0X00 00	X00000X01
100000 0000X 0000001
11111111111111111111
