NO test_artifacts/valid.xpm
SO test_artifacts/valid.xpm
WE test_artifacts/valid.xpm
EA test_artifacts/valid.xpm
F 215,79,62
C 17,247,153

11111111111111111111
100000 000 0 000XX01
100X0	000000	000X001
1X000000	000	X0 0001
1000000000	000X00X01
10	X0X00000000000X 1
100000000X000000N001
100000 0X00 00000001
10 00 0X000000XX0001
100		000 X00000000 1
1	X00X	X00000X00 001
1 0000000X0000000001
1X0000 0 00000	00001
10000000000	00X00001
1 0	0000000 000X0001
1X00 00X00X000X00001
10 X0X0000000 000001
1000000000 000000001
1X00 0	 00000 0000X1
11111111111111111111
