NO test_artifacts/valid.xpm
SO test_artifacts/valid.xpm
WE test_artifacts/valid.xpm
EA test_artifacts/valid.xpm
F 67,43,122
C 198,252,193

11111111111111111111
10000000 00 0000X0 1
1X00 0X0 0X000000 01
1	00 0000X000000	001
100000	00000000000X1
1 0000	X000000000001
100000X00 0 0 X0 001
100 0X0X0000	00X0001
100XX0X0 00000000001
1 0 000 	000X0000001
10	0X0000000 000	0 1
10000 0000 0 0000 01
100000 0 N000000 001
100 0	00 0	0 00 00X1
100X0XX000000 0 0X01
100000	00 00 00000	1
100000 X00	0000 X X1
10X00000 00 00000001
1000000X0	0000000001
11111111111111111111
