NO test_artifacts/valid.xpm
SO test_artifacts/valid.xpm
WE test_artifacts/valid.xpm
EA test_artifacts/valid.xpm
F 66,,0,0
C 99,114,209

11111111111111111111
10 00X X0	000000X0 1
100000000X 	 0000001
10		000000X00 0 X001
1 00000000000000  01
100XX000  0000000001
1  	0 000	X00XX00001
10000000X 0X	0 00001
10000X0000 000X00 01
100000XX00X0000X00 1
100000000X 0X0000X01
1X00X0000 0 00000001
10X0000 000000000001
1 0X00 000000	000 01
10000X 0X 00 0X00X 1
1000  X	00000	XX0001
10000N0X	0 0	 00	X01
1XX 000	000 X0X0 001
1	 0X0000X0XX0X00X01
11111111111111111111
