NO test_artifacts/valid.xpm
SO test_artifacts/valid.xpm
WE test_artifacts/valid.xpm
EA test_artifacts/valid.xpm
F 143,49,31
C 1,190,233

11111111111111111111
100X 00X00	000X00001
100  	0	000000000001
1000000 X00X0X00X001
1000	0	 0X000X00 001
10 0 0000 0000 00001
1X000 00000 00000	01
1X00000000X0X 000001
1 00000X0X0	0 0  0X1
100000 0 00000	00001
100	00000X00 0000X 1
100 00 0000 X00X0001
100X 	 00000000 0001
10000	00000X000 00X1
1	0	000X0000000	 001
10000000 0000X0 	 01
10 	00000000 X00X001
1000	00N00 00 000001
1000000 00000 0X 001
11111111111111111111
