NO test_artifacts/valid.xpm
SO test_artifacts/valid.xpm
WE test_artifacts/valid.xpm
EA test_artifacts/valid.xpm
F 7,56,214
C 7,3,82

11111111111111111111
1000000000XXX0000001
1 000000000X00	X 0 1
10000000 0000X 		0X1
10000 0000	00X000001
10 0	X00 00	00000 01
10X XX00000000000001
1	0 00000000000X0X 1
1	0000		X000  	X	 01
10000000000X0X	 0001
10XX0000 XX00	X0	0 1
1000	000000X000X0001
10	00000000X00000001
10 000000	 000000001
10000000000000000001
10X00 0	N00000 00001
100 00000000	000	001
10000000000X000  001
1000000000X 00000001
11111111111111111111
