NO test_artifacts/valid.xpm
SO test_artifacts/valid.xpm
WE test_artifacts/valid.xpm
EA test_artifacts/valid.xpm
F 147,148,85
C 165,44,43

11111111111111111111
1000	0000	0000 00001
100000 000000X		 X01
10X000X 0000 X 00 	1
10000000X000000	0001
1	000	0000000000X 01
100000000X00X000 001
1	X0 0000000000X0001
100XX000 0000X000001
1X0  000X00X000	0001
1 X 	0X0 00000X00 01
1N0000000XX0000 00	1
10000 0 00000X0X00X1
10000X00000000000001
10000 000000000X00 1
100   00000	X0000 	1
1X 0000	  0X0X000 01
1 0000000	000000	0	1
100000 	000X000	0001
11111111111111111111
