NO test_artifacts/valid.xpm
SO test_artifacts/valid.xpm
WE test_artifacts/valid.xpm
EA test_artifacts/valid.xpm
F 43,0,0
C 6,130,165

11111111111111111111
1	X000000X00 00 0001
10000000000000	00 01
1000X000000 00000001
1 X  0000000 0X0NX01
100 X 	000 	00000001
100XX00	00 0 0 00001
10000 0000000	000001
10XX0000000000 00X01
1X00000000000 	00001
1X0 X00X00	  0000		1
10000000000 00000001
1000 00000000000X	01
1 	00X0 X0000 0X0X01
10000 0X000X00 0 0X1
10 0XXX0000 00000001
1000000 0 000000 001
1000000 000000 00 01
10X00	000X00000000X1
11111111111111111111
