NO test_artifacts/valid.xpm
SO test_artifacts/valid.xpm
WE test_artifacts/valid.xpm
EA test_artifacts/valid.xpm
F 106,197,100
C 107,185,209

11111111111111111111
10100000001000010111
10101001110000000101
10001000100110001001
10010011011100000011
10000000100000000001
11100000010010100001
11000000000000001001
10001000001000000001
11010000000000010001
10000001000000000001
11000000100000001101
11001001110001000001
10010100000000000001
10000000001001000001
10000010010001100001
10000000000010000111
10N01010110000000001
10000000000010000001
11111111111111111111
