NO test_artifacts/valid.xpm
SO test_artifacts/valid.xpm
WE test_artifacts/valid.xpm
EA test_artifacts/valid.xpm
F 39,0,0
C 153,236,247

11111111111111111111
10000X00000X00X00X01
1X0XX 00000000000001
1000000 0X0000X0X	01
10000 X000000000 001
100	 00 X000X0X00001
10000X 00000  000001
100 X00 X 000 0000X1
10000	00000X	0000	01
1000000 	00 0000X001
100 	000000X000000 1
1	0000 	0 000X00 001
1X00000000X 0X0 00X1
10000000X000X0000001
100000000  00000	001
1X 0N0 	0 0X000000X1
1X00000000 0	0000X01
100000X00X0000 00001
100 000000000000X001
11111111111111111111
