NO test_artifacts/valid.xpm
SO test_artifacts/valid.xpm
WE test_artifacts/valid.xpm
EA test_artifacts/valid.xpm
F 126,55,151
C 23,74,190

11111111111111111111
1000000 X0X0000X0001
1	0X00000000 00000X1
10 0X00  00	X 	000	1
100	0000	000000XX001
1X000000000X0X00 0X1
1X0 00X0000000000001
100X000	 0000X000001
10000X000 000 X0X001
10 0X000	00000000001
10X0 00		00	X 00XX 1
10 0000X 00000	0 001
10 0000 000000000001
1X000X000000000000	1
10000000000X 0X00X01
10X0000	00000X0	00 1
10000000X00X0 000 X1
10X0000000NX0X000001
1000000000000000X001
11111111111111111111
