NO test_artifacts/valid.xpm
SO test_artifacts/valid.xpm
WE test_artifacts/valid.xpm
EA test_artifacts/valid.xpm
F 180,96,123
C 101,209,214

11111111111111111111
11000000000000111001
10110100110010001001
11001100010000000001
10000001101001010001
10010001000000000001
10011000000100000001
100000000N0000000011
10010000000011010001
10000010100000000001
10001101001100000001
10010100000000000101
10001000000000100011
10110000001000100011
11000001000000110101
10000100000010000001
11001000100000010001
10000100100100100001
10000100010000000101
11111111111111111111
