NO test_artifacts/valid.xpm
SO test_artifacts/valid.xpm
WE test_artifacts/valid.xpm
EA test_artifacts/valid.xpm
F 141,175,50
C 63,70,238

11111111111111111111
10010101000000000001
11011001000011101001
11101000000001001001
10000000100010000111
10101000100100000001
11100000000000000001
11000000000010000001
10001000000000000011
11001000011000000001
10000000101010010001
10000000100000000001
10000100001010000001
10000010000001000001
1000N000000011000001
11000011100010000001
11011100000001000001
10000101010000001001
10001010010000001011
11111111111111111111
