NO test_artifacts/valid.xpm
SO test_artifacts/valid.xpm
WE test_artifacts/valid.xpm
EA test_artifacts/valid.xpm
F 231,34,201
C 79,63,6

11111111111111111111
11011000001100000001
11010100110000001001
10001000000000101001
11100011000000100001
10000010000100000101
10010000100011000011
10000000000000000001
10000001010011000001
10001000000000100001
1000110N000100000011
10110000000001000001
10000100000000001001
10000000000001010001
10000010001000000101
11000000100001010001
10100000000000001001
10010101000000001011
10000010000111000111
11111111111111111111
