NO test_artifacts/valid.xpm
SO test_artifacts/valid.xpm
WE test_artifacts/valid.xpm
EA test_artifacts/valid.xpm
F 142,236,180
C 171,225,144

11111111111111111111
10001010000110000011
10100001000000000001
10000000000000000001
10001100010000000111
10100000000001011001
10000101001000000011
10000000000010000001
10000000010000000001
10100011101000101001
1100N000110000110101
10000001101111100011
10000000010100000101
10000000000001100001
10000011000000000001
11000001000001000001
10000000010000101101
10000000010000000001
11011001101100000101
11111111111111111111
