NO test_artifacts/valid.xpm
SO test_artifacts/valid.xpm
WE test_artifacts/valid.xpm
EA test_artifacts/valid.xpm
F 121,7,31
C 31,124,150

11111111111111111111
10 000000000000000	1
1X0000000000000000X1
1	00X0000X00	0000X01
100 0X0	XX00   000 1
1 0000000X000000 0 1
100000000 00000000	1
100X00X0000X0X0 X001
100XX00000000X0X0001
100000X0 XX00 00X001
100	0000	00000 0 001
1000000X000000000001
1X0X00000 0000000001
1 000X0 XX00 0 000 1
100 00000X0 000 0001
100 00000X000  X0001
1000  000X000X000001
100X0		0X00X 000N0 1
1 X00X0000X000000001
11111111111111111111
