NO test_artifacts/valid.xpm
SO test_artifacts/valid.xpm
WE test_artifacts/valid.xpm
EA test_artifacts/valid.xpm
F 216,246,205
C 189,223,138

11111111111111111111
1000000	000 0000 0	1
1X000000000000000001
100X0000	000	00 	001
10 X 00X0X000	000001
10 0000 000 00000001
10 000 0	00N	000X 01
10 00000X000X00 0001
1000000X0000X0000X 1
100 000 00000 000001
1	00000	0X X0 	00001
1 00XX0000X0	00	0001
1	X00 00  0  00X0001
1	00000 00 00000X	01
1 X0	0000	0000	00X 1
100000000	0X	0000 01
1000	0000 00000	0001
10000	 000000000 001
1 00X00000	X00000X01
11111111111111111111
