NO test_artifacts/valid.xpm
SO test_artifacts/valid.xpm
WE test_artifacts/valid.xpm
EA test_artifacts/valid.xpm
F 140,232,181
C 222,122,61

11111111111111111111
10	00	0	000000 00	01
10 X0	0000X00X000001
10 0000	0000000 0001
10 000000000000000X1
10000		00	X0X0000001
10X0000	 0000XX 00 1
1000	00 0000000	0001
1X0	000000	00X000001
1000000X	00000 00001
1 000	0000 0000000 1
100000000X0X 000	001
1000000 0000X0 00 01
100XX	N00 0	000	0X01
100000000000X000X001
1000X00000	0X00000 1
1	00000		X	X	00X 	01
10X00 	0X 0000000001
1000 00 0 000000 001
11111111111111111111
