NO test_artifacts/valid.xpm
SO test_artifacts/valid.xpm
WE test_artifacts/valid.xpm
EA test_artifacts/valid.xpm
F 67,90,178
C 94,25,210

11111111111111111111
11000000010000010001
10000000101000101011
10100000110001000001
10100001000100000011
10110000000010000001
10000000000000110001
11000000001010000111
11100001001100000001
11000001101001001001
10000010100000000001
1000011010000N000001
10100100000000001101
10001100010000000101
10001000001100000001
10000011001000001001
10000010100000001001
10011010000000010001
10100000000000001001
11111111111111111111
