NO test_artifacts/valid.xpm
SO test_artifacts/valid.xpm
WE test_artifacts/valid.xpm
EA test_artifacts/valid.xpm
F 178,110,175
C 20,93,68

11111111111111111111
10000100001010000101
10000000000010001001
10000000000000001101
10000000000000N00011
10100000000010001001
10010000000000000101
10110000010001000111
10000000001010000001
10001101100011000001
10000000000000000001
10001111010000000001
10100010000100001001
10000000100100001101
11110010010000010011
10110000100110010011
10000100000000000001
10001100000001011111
10010000010010011011
11111111111111111111
