NO test_artifacts/valid.xpm
SO test_artifacts/valid.xpm
WE test_artifacts/valid.xpm
EA test_artifacts/valid.xpm
F 142,0,0
C 223,48,233

11111111111111111111
1000000 0000X0 000 1
1 000000X00X0000 0	1
10 0 00X0	000	000001
1 0 0000X00X 0X000X1
1	0		00	 00 0 X0	0X1
1 0X000000000 000001
1000000000000X000001
1X0000X0000000000		1
100000 000X00000 001
1 00000 00000000 001
100000	  00000	00 01
100000000 00000 0 01
1000X0 0 0NX0 0  0	1
1000 0 00 X000 0X0	1
1000X000		0 00 000 1
1	00X00X0 000000 001
10XXX000000 00000001
100X0000	0X0	 000001
11111111111111111111
