NO test_artifacts/valid.xpm
SO test_artifacts/valid.xpm
WE test_artifacts/valid.xpm
EA test_artifacts/valid.xpm
F 83,120,175
C 76,148,7

11111111111111111111
1000 X000 X000 0X001
1000X 00 0000 000001
100X	00XX 0X000X	001
10X000  0X0000000001
10	00 0000 000	X0001
10000X0X0000 000 001
10000X000X00000 0001
10000 0 X0X000000001
1000 0X00X00 XX00001
100000 0X00X000 0001
1XX00000X0	00XX00001
10 XX00000000XX0XX01
100000X000X0X 000001
1XX000000	000 00X 01
10 000X00X 000	000	1
100000000X0	0  00 01
10  X X0	X00	0	0X0N1
1	00X0	000	00000 	01
11111111111111111111
