NO test_artifacts/valid.xpm
SO test_artifacts/valid.xpm
WE test_artifacts/valid.xpm
EA test_artifacts/valid.xpm
F 98,59,86
C 138,207,27

11111111111111111111
100	000 0	0X00000	01
10	0000000X00X000001
10000000X	 0000 X001
1X0N0000000 00	00001
1000 0X000 000000001
1X 0	00X00  000X0001
1000	0000	0 000	0X01
1 0X	00  0000000X001
100X0X00X0X0	00 0001
1XX00X0	0000 0 00 X1
1  00000X00	000 0001
100000000000 	0	0001
10		000000000000X0 1
100X0000000X0 0X 001
1X0 0000 X0000  0 01
1	0000X0000	0X000001
1000X00000X0 00	0001
1 0 0	0000	0000X	001
11111111111111111111
