NO test_artifacts/valid.xpm
SO test_artifacts/valid.xpm
WE test_artifacts/valid.xpm
EA test_artifacts/valid.xpm
F 255,162,137
C 214,146,54

11111111111111111111
10000000X0		 0000X01
100000 0X00000000001
100	 0000 0000000001
10000X0X0000XX	0X001
1000X0000000 	000001
100X0X000000000 0001
10	00X0000X000	00001
1X0000 0000000000001
1		00000000000000001
1000	000	000 0 00 01
1	0	00 00000000X0 01
1000 0X 0XX000N00X01
1000  000X 000000 01
10 X00 00 0000000X01
1000X	000 0	0 000001
100000X0X00000000	01
1000 0 0		00X 000001
1 000000 0 000 00001
11111111111111111111
