NO test_artifacts/valid.xpm
SO test_artifacts/valid.xpm
WE test_artifacts/valid.xpm
EA test_artifacts/valid.xpm
F 76,181,70
C 76,191,127

11111111111111111111
10001000111100010001
10000010000000010011
10000000000000001001
10000010000100100111
10000010101100000001
10001000000010001001
10000000000100000001
10100000000000001001
10010001000110000001
10110000001000100001
10000110110100000001
11101000010010100011
11000111001000000101
10000000000010000001
11010000011010000001
101010001000000N0011
10001000010001000001
10000000000001000001
11111111111111111111
