NO test_artifacts/valid.xpm
SO test_artifacts/valid.xpm
WE test_artifacts/valid.xpm
EA test_artifacts/valid.xpm
F 248,0,0
C 113,208,28

11111111111111111111
10000000000000000001
1000 0000000000000X1
10000  00 0 0000 001
10	000	0X0000	000001
100000000000 00000	1
100 0X00000000000001
1000000000XX0	X00	01
10000 000X00	0 00001
1000000000X 000 X001
1	0000000X00X00000X1
100X0 0000000XXX XX1
100N00000 0000X0	001
1 0 00000000000000 1
10 00 000000000	 001
100X00 0X0X0	X00X001
1000 0X000 0X	X 0 X1
100X 0X0000X00 00 01
10000000000000000001
11111111111111111111
