NO test_artifacts/valid.xpm
SO test_artifacts/valid.xpm
WE test_artifacts/valid.xpm
EA test_artifacts/valid.xpm
F 185,53,6
C 226,81,203

11111111111111111111
10111110000010000001
10000000000000000101
10011010010011010011
11010000000001100001
11000001000000000001
10010000010000001001
10001000101000000001
10000100000001101001
10010000100000000001
10001000000010000001
10000001000000011001
10000001010000101001
10100000000000000001
10001001010000000001
1100000000000000N001
10000000010010000011
10011000000000000001
10000100000000000001
11111111111111111111
