NO test_artifacts/valid.xpm
SO test_artifacts/valid.xpm
WE test_artifacts/valid.xpm
EA test_artifacts/valid.xpm
F 242,45,54
C 214,90,115

11111111111111111111
10000000100000000101
10010000000010000001
10001000100000000001
11010100000000000001
10000000010000000001
10101000000001010001
10000100000100010001
11010011001000000001
10101000110010000001
10001000001100000001
11000010000000100001
1000N000011000000011
10100000000100011011
10100001000000000001
10110100100110010101
11000001000000000001
11000001000100010001
10100010001001000001
11111111111111111111
