NO test_artifacts/valid.xpm
SO test_artifacts/valid.xpm
WE test_artifacts/valid.xpm
EA test_artifacts/valid.xpm
F 41,236,121
C 225,20,99

11111111111111111111
11001000001100000001
10000100000010101101
11000100100100100011
10000000000010010011
11000000100000000101
11000000000100000001
10000010000101000001
10000011000010000001
10011010010100000001
10100101000100000101
10000010100000101111
100N0000000000001001
10000000100000000101
10000000001000000001
10000000010000001101
10100000001100000101
11000001100110001001
10000100000000001001
11111111111111111111
