NO test_artifacts/valid.xpm
SO test_artifacts/valid.xpm
WE test_artifacts/valid.xpm
EA test_artifacts/valid.xpm
F 248,80,229
C 124,232,58

11111111111111111111
10000000100000000011
10100000000010000001
10010110000001000001
10000101000001000001
11000000010010100011
11000000010000000001
10100000000001001011
10000010100000000001
10100001010000000001
11100000000000000011
10010100N00000000001
10000010000110000011
10101011100000010011
11000000000000000011
11000000100000110101
10000001101100000011
10000100000000000101
10000101001000100001
11111111111111111111
