NO test_artifacts/valid.xpm
SO test_artifacts/valid.xpm
WE test_artifacts/valid.xpm
EA test_artifacts/valid.xpm
F 226,198,55
C 95,220,23

11111111111111111111
1000000000 000	00	01
1N00	 X000X 00000 X1
1 00 00 0	0XX0X	0001
10X0X0X00XX00000	0 1
10000000000000000001
10000 00000	00X000X1
10 0000 00X0 0 0X001
100X0	00X00X00 00X01
10000X00000X00X000 1
10 X 	XX000 XX0	0 01
1000000 00	000000001
100000 0000X00 0 001
100  000000X00000001
1000 0X0 000	00	0001
100 00000 X0000	00X1
10000000X000 00 	0 1
1000X0000X0 0X0  X 1
10X0X0X00X000X 00001
11111111111111111111
