NO test_artifacts/valid.xpm
SO test_artifacts/valid.xpm
WE test_artifacts/valid.xpm
EA test_artifacts/valid.xpm
F 34,75,172
C 117,126,174

11111111111111111111
10010001000000000001
10000000010001100001
11000110100100000011
10000101001000000001
10000000000000100001
10100100010010100011
10000000010000001001
10000000000010100111
10000100001000000001
10100000010000010001
10100000101000100001
10000000001011000001
10000001000100001011
10000000010100011101
10010N00000001000001
10000000010010010011
10000100101000000111
10000100000001001011
11111111111111111111
