NO test_artifacts/valid.xpm
SO test_artifacts/valid.xpm
WE test_artifacts/valid.xpm
EA test_artifacts/valid.xpm
F 41,0,0
C 22,45,248

11111111111111111111
1	X0 000000000000001
10000000000000000001
1X0	000000X0 00X0001
1	N	000000000X0000	1
1000 0		000	00 00001
1X000000 000000X0	01
1X000000000000000001
1	00000 0  0	0000XX1
10000X00 X0  0X0	 01
100 X000 00000X00 01
10X000XX0000000 0001
10000000X0000 00X0X1
1000X0 00 0	0 0	0001
1 000000000000000001
1		0X 0X000000XX 001
1 0000000000000X0 01
10000000X0000 XX0	01
100 00000000 0X00001
11111111111111111111
