NO test_artifacts/valid.xpm
SO test_artifacts/valid.xpm
WE test_artifacts/valid.xpm
EA test_artifacts/valid.xpm
F 74,182,196
C 198,225,100

11111111111111111111
10000001000100001001
10010000000011001001
10000000000000000001
10101010000000000011
10101000110000001011
10000001001100110001
10000001000000000001
10010001010100011001
10001010100001001001
10000100100100000001
10010000000011001001
11000000100000000001
10000000010000000001
10000000100000110001
100000000000N0001011
11000000010000000111
10000000000000000001
10100101000000000101
11111111111111111111
