NO test_artifacts/valid.xpm
SO test_artifacts/valid.xpm
WE test_artifacts/valid.xpm
EA test_artifacts/valid.xpm
F 53,252,51
C 37,173,26

11111111111111111111
100  0 00XXX000X 0 1
100000 0	000000 	001
1	0  00X0000X000X	01
1	00000000000X000001
1000000000 0000000X1
10000 X0N00000000	01
1X0X00 X0X0000000	01
10000	X000	00000 001
10X 0X0	X0000000		01
1000X00	00 0 X0000	1
1000 000000000000X 1
10000X00X0000X000001
10000 	000 0X 000 01
100X0 00 00	X0X00001
10000X0XX00  0		00X1
10  00000	0X00000001
1X00000 0000000 X 01
10000000 X00X0000001
11111111111111111111
