NO test_artifacts/valid.xpm
SO test_artifacts/valid.xpm
WE test_artifacts/valid.xpm
EA test_artifacts/valid.xpm
F 112,50,61
C 210,65,2

11111111111111111111
100	0X00000X0XX 0001
10	 X000X	00 0000001
100X000	 00	0	000001
100X00	0000000000001
1X00  X0XX0000 00001
10000000	00 000	0001
1	000X00000000X00001
1	0 0000000000000001
10000	00 0XN0 X00001
1X00X000X00	0000X0 1
10000000 0XX 0X00 01
100X 00000	  00000X1
1 	X 000X0X000000001
10000000000	 X000001
100000000 0X0	 000X1
100000	0000X0		0 0X1
10X000X0000000 	0X01
10X00 0000000X0000X1
11111111111111111111
