NO test_artifacts/valid.xpm
SO test_artifacts/valid.xpm
WE test_artifacts/valid.xpm
EA test_artifacts/valid.xpm
F 72,,0,0
C 39,227,157

11111111111111111111
100X  000XX0000	0001
10X00000000 X0X00001
1000X00000000	000001
1000000000 0000000 1
1 000	 0000X00000001
1000 000X0 000000001
1X000 000	X000X	0X01
100	0X X000X00000	01
100000 000000 000001
1000X 0		0000X000X01
100X0	00	000 000	001
10X00 	00 000000N001
10X0 X0 0000X 000001
1000000	000X0 00	0 1
100	0  000000X000X01
1X00X 00000		000X 01
10000 	0	00	 000 0X1
1000000000000000X0X1
11111111111111111111
