NO test_artifacts/valid.xpm
SO test_artifacts/valid.xpm
WE test_artifacts/valid.xpm
EA test_artifacts/valid.xpm
F 133,21,12
C 226,84,151

11111111111111111111
1000 00X0X00		0000X1
10000X  00	000000001
1000 00000 	00X0	001
1000000	0 XX0 000001
100 0000N X00X  0001
100 000  00 00	0 001
1	00 0000X 00000 001
100000000 0000000 01
10000 00000 0000		01
1 0	0  0000X0000X001
1000000X0000000X0001
10000 X000X00 00 001
10 0XX000 0000000001
1000XX0	00X000 00001
1 000 00000XX 0	00X1
100000	000000X 00001
1X 0000	X  000 00001
10 00000000 0000 X01
11111111111111111111
