NO test_artifacts/valid.xpm
SO test_artifacts/valid.xpm
WE test_artifacts/valid.xpm
EA test_artifacts/valid.xpm
F 189,151,51
C 95,44,104

11111111111111111111
1 0000	0000000 0   1
1 00XN  0000000X0001
10	000X 	00 X0X0X001
10X00X00000	0X000001
100 00000000000		001
100000000000X 0 0001
10X00000 X0000 00001
1000	000000X	X	00001
10000  0	 0 0000X0	1
10000000X000000	0001
10 000000	0000 00001
10000000 X0000000 01
1X0000X0000000X0X001
1		X	000  0000	000	1
10X	X 000X00000X0001
100X0 X00 0000000001
100X0000000 0000X001
10 0000 000000XX	 01
11111111111111111111
