NO test_artifacts/valid.xpm
SO test_artifacts/valid.xpm
WE test_artifacts/valid.xpm
EA test_artifacts/valid.xpm
F 88,226,167
C 202,20,40

11111111111111111111
10000000010000001001
10010010000000000001
10110010000000010001
11000100000000010001
11000001110101000001
10010000000000000111
10000000100011000011
1001000000000000N001
10011101000000100001
10010001011000000011
11000000000000001001
10000111010001011001
11000010100000000001
10001010000110000001
10101001010001010011
10000100000000000001
10000001010000100011
10001000000000011001
11111111111111111111
