NO test_artifacts/valid.xpm
SO test_artifacts/valid.xpm
WE test_artifacts/valid.xpm
EA test_artifacts/valid.xpm
F 95,87,117
C 7,27,50

11111111111111111111
10X0X 00000X0000XX01
10 000000 00	0X00 01
1000000 0000000X0001
10X0  0000	XX00000X1
10000000000 0X000001
1X00000 0  00X 00001
100X00	0000000	00001
1X 0 0 0000 0X000001
1000000X0 00000 0001
10	0 0	0 0X0 0 0  01
100000000X0000000001
100000	0	0 000000001
100000000X000000X 01
1000XX0000	X00000X01
10000NX00000  000001
10 0000X000000X0 001
10000XXXX X0000 0001
1000	00XX0000 X00 01
11111111111111111111
