NO test_artifacts/valid.xpm
SO test_artifacts/valid.xpm
WE test_artifacts/valid.xpm
EA test_artifacts/valid.xpm
F 144,82,57
C 219,194,59

11111111111111111111
11000010001011000001
11000000010000000001
10101000000000001011
10010000001000000001
10000100001000N00001
10010001010000000001
10000000100000000001
10100010000100000001
10000000000000010001
11001001000000111001
10001001000000100001
10010011001010010011
10000100000000000101
10001100000010101001
10000000000100000001
10010000000010010011
10000010000100000111
10000100000000100001
11111111111111111111
