NO test_artifacts/valid.xpm
SO test_artifacts/valid.xpm
WE test_artifacts/valid.xpm
EA test_artifacts/valid.xpm
F 206,33,4
C 55,225,18

11111111111111111111
10000000000000000X01
10000000X00 0X 00001
1000000 00X000 00001
1	0000000000000X 001
10X00X0 0000000 0001
10 00000N00000X0 001
100000 0000000X 0001
1	 00000	0000X0 0 X1
100	000X0	X 00000001
10	00000X000 X0	0001
1000000	000	X0000 01
10X0000000X0000000X1
100000000X000 00 001
100000 	0	0 0X0000X1
1 0X00X0000X00 000X1
1000	000000000000001
10X	00 0000000	 00 1
100	X0000	0 00000001
11111111111111111111
