NO test_artifacts/valid.xpm
SO test_artifacts/valid.xpm
WE test_artifacts/valid.xpm
EA test_artifacts/valid.xpm
F 166,0,0
C 133,51,17

11111111111111111111
1X 0000 000000000N01
10000X0XX00000000001
1 XX 0000	X00 000X01
10 	000X000000000001
1 00000 0X00000 0001
1 00000	00000X0	0  1
1X00	  000  00000001
10000000X00000000001
10000 0000 0 0000	01
1000X00 000X00X000 1
100X000X	00000 00001
1000X00   X000		00X1
100000000	00	000X001
1 0000 0 00000000	X1
10X000000000000X0001
1	000	0 0X0000X00X01
10 00X0000	X000000	1
1000	0 0	00000 00X01
11111111111111111111
