NO test_artifacts/valid.xpm
SO test_artifacts/valid.xpm
WE test_artifacts/valid.xpm
EA test_artifacts/valid.xpm
F 8,142,117
C 131,235,250

11111111111111111111
10000000000101000001
10000000100100111001
11010000110010000001
10100101000000000001
10001001100000000001
10111101000010100011
10001000000010001011
10000000000000000001
10010110000000110101
10000000001010000001
10101110000101010001
11000100N01010010001
10110000001100001001
11000101000100001011
10010000001000011001
10000001110000100011
10100000100000010001
10010101100001010001
11111111111111111111
