NO test_artifacts/valid.xpm
SO test_artifacts/valid.xpm
WE test_artifacts/valid.xpm
EA test_artifacts/valid.xpm
F 157,79,26
C 150,91,195

11111111111111111111
11010000010000001001
11000000001000000011
10010000000101010111
10100100011110001001
10010100000010000001
11000000N00010000101
10000010001010000011
10001000101010011001
10000100000100000011
10000000001010000001
10000001000001000001
11000000100000000101
10000001000100100001
10101100001000100101
10000001000000000101
10111000010100000001
10000000000000000001
10000101101000001011
11111111111111111111
