NO test_artifacts/valid.xpm
SO test_artifacts/valid.xpm
WE test_artifacts/valid.xpm
EA test_artifacts/valid.xpm
F 143,0,0
C 166,107,102

11111111111111111111
10  	0X 0000  000001
10000000X00000000X01
1X00X0 0X	N000  00X1
100000000 0000 X0001
1 0 0 0000X000 000X1
10 0000X 0 X00000	01
100	 00 000000 00001
10X	X0X000 00000X001
1 	0000X000000X00	01
10000000000000000001
1 X00000000000X	  01
1000	00000000000 001
10 0X 0000X000X00001
100	00	0 	0000	X0 01
10X	0000000X 0X 0001
10X000000000000000X1
10	00000	0X00000 001
1000X0X0000000X00001
11111111111111111111
