NO test_artifacts/valid.xpm
SO test_artifacts/valid.xpm
WE test_artifacts/valid.xpm
EA test_artifacts/valid.xpm
F 180,,0,0
C 32,227,58

11111111111111111111
1X00	0000 X0000000X1
10 00	0000 0 00000X1
10000X0	00X0X00 00	1
1X0000 000 000000 01
10000000	0X0X000X001
10X0 0000000000	0001
1000000000000X00XXX1
10X0X000	0 0 0000001
10000 00000000	00 X1
1X0X0000000X000 X001
100000	0	000	000X001
10X0 000000000000001
10000X	000000000 	01
10 000 N 00000000001
10 000000	 00000 001
10	000 0000000000	X1
10X00000000000000 01
10000000 0	000000001
11111111111111111111
