NO test_artifacts/valid.xpm
SO test_artifacts/valid.xpm
WE test_artifacts/valid.xpm
EA test_artifacts/valid.xpm
F 95,211,111
C 241,153,198

11111111111111111111
1000 0X0X000000		001
1	0 00000	00000000X1
1X 0XX000000XX00X 	1
1000000000	000000X01
10 XX00000000X0X0001
1	0 000X0X000000  X1
1X00000	00000 0 0001
1 0	N0 0 X00000 X 01
100000X000000000 0X1
1  000000000000 0	01
100000	X0000000 00X1
100000 000000 0 X 01
10X000 0X00000	000	1
10 000 	00000000X001
10 00  0X00000000001
1	00000X0 0XX000X0	1
1 000000000		00000 1
100000 0 00 	0000  1
11111111111111111111
