NO test_artifacts/valid.xpm
SO test_artifacts/valid.xpm
WE test_artifacts/valid.xpm
EA test_artifacts/valid.xpm
F 16,46,227
C 72,122,150

11111111111111111111
1000XX00 00X00000X01
1X00 00	 00 0X0000X1
1	0000	0X	0 000X0001
1X0 000 000	X0000001
10000X00N000000X0001
1X00X000X00000  00X1
1X0000X00 0X0 	X0X 1
100X0	00000 0X 00001
1000X0	00	00X X0  01
1	X	000000 0X	0000 1
1 00000 0000 0000001
1 X0	00X0	0000 00001
1000X0000000X00000 1
1000000 	000 0X 0001
100 0000 	0000000001
1	00000000000XX00001
100000  0X0000 0X 01
1 00	0X00 0000X000	1
11111111111111111111
