NO test_artifacts/valid.xpm
SO test_artifacts/valid.xpm
WE test_artifacts/valid.xpm
EA test_artifacts/valid.xpm
F 28,192,211
C 191,204,119

11111111111111111111
10000000100000000011
10001000000000000001
10000001001000001001
10000000100010010001
10000110010101000001
10000000011110100011
10000100000000000011
10101000000100000001
10000000000000000111
10100010101010011001
11100000100010110001
10000000000000000001
10010000010001001001
11000000000000000011
10000N00000000000001
10000000001001101001
10000000100100000001
10100100000001000001
11111111111111111111
