NO test_artifacts/valid.xpm
SO test_artifacts/valid.xpm
WE test_artifacts/valid.xpm
EA test_artifacts/valid.xpm
F 172,62,166
C 96,213,142

11111111111111111111
10000000000000000001
10000000N01000000001
11001000001000001101
10000000010000001001
10000000100001010001
10000000000000001001
11101000100100000001
10000001000000001001
10001010010010000101
11000000100000010011
10000000010000000011
10001000100000011101
11110101000100000011
11000001100010000101
10101010010000000101
11010100010000110001
10000000100000000001
10000000000010000001
11111111111111111111
