NO test_artifacts/valid.xpm
SO test_artifacts/valid.xpm
WE test_artifacts/valid.xpm
EA test_artifacts/valid.xpm
F 48,239,245
C 109,158,10

11111111111111111111
100	000	00000000X001
10000000 X	0000  001
10 00X000000 00X0001
1000000 0X	 0000X001
1	X00000 0X0		000001
1000  00000X	0000 	1
10000	000 00000 0001
10 0 0000000X00	00 1
1N0	00	000000 X00001
10	0000000000 000X01
1000	X00000000X00X01
1	0	0 0 00 00000 0 1
1X  0000 0000 0000 1
1000 0XX00000X0	0	01
100000		 X0X0	 0  01
1 0000X00X0X00000001
100000000000 0000001
10X0000X00000 	0X 01
11111111111111111111
