NO test_artifacts/valid.xpm
SO test_artifacts/valid.xpm
WE test_artifacts/valid.xpm
EA test_artifacts/valid.xpm
F 112,118,113
C 123,255,108

11111111111111111111
10000000 000000 0001
1 0X 0X000X00	0 0001
10 00 000000000X0001
10 000 00000000000X1
10000X00X	00000	0001
1000000000000000XX01
10X0X00000X00	X000X1
100X00  0X	 00000001
10 0000X 000	0X00X01
10000000000000000001
10 00000000X000X0001
1X00 0	X00 X000 0001
100X 0X	00X000000001
1000000X00 00 00 XX1
1000 X0000X00XX000 1
10X 0000X00000000001
1000X000000X 0000 N1
10000000 X0	00X00001
11111111111111111111
