NO test_artifacts/valid.xpm
SO test_artifacts/valid.xpm
WE test_artifacts/valid.xpm
EA test_artifacts/valid.xpm
F 244,0,0
C 114,157,22

11111111111111111111
1 0  0	0 000X00	00 1
10 0000X0X00X000 001
10000000X00000 000 1
100 00000X0000000001
10 0 000	0000000	  1
100000000X0   000X 1
1000	X00 00000X00X01
1	X00X0X0  000000X	1
100000	0000X 0	00001
10	00000X00000000001
10 N0 000 0000 00	01
1 0000000	0 000X00X1
10X00X0	0000 	000001
1000000 00000 00X 01
10X0  0X00000X000001
1 00000XXX 0	00 0001
1	00X000000 0X0 0001
1 000X00000 000X 001
11111111111111111111
