NO test_artifacts/valid.xpm
SO test_artifacts/valid.xpm
WE test_artifacts/valid.xpm
EA test_artifacts/valid.xpm
F 183,171,76
C 160,253,226

11111111111111111111
100X0 0X000000000001
1	0	0000000X00000001
1000000000000000 001
100X0XX0 000	0000	01
10000000X00X00000	01
100000000X0	000	0001
100000000	0000X00001
100	0000000000X00001
10 00000X0N	0	00X001
1000X0 00000000X0001
10 X00  0X X00000001
10000X 00000	0 00X01
10000000 00	000  001
10000X00 000000X0XX1
100	0 000000X0000001
100000000000 X000001
1 XX00000000	0000001
100000	000000	X00001
11111111111111111111
