NO test_artifacts/valid.xpm
SO test_artifacts/valid.xpm
WE test_artifacts/valid.xpm
EA test_artifacts/valid.xpm
F 169,189,91
C 196,190,94

11111111111111111111
1	000X00000000000X01
100	00	0X000 000	001
10	00000000000X00	01
1X0 000000	X0000X001
100X000000X0 0000001
1000000000 0	0000001
100X00000 0	00000001
10	000XX000X0X000001
10000X00X000000	  01
1 X	00X000	00 000		1
1000000X000	00000 01
100000000000 0000001
1000000000000	0 X001
10 0	0XX00000	000X01
100	 0000000000X0001
10000 00XX00000 00X1
1 00000000	00 0 0 X1
1000X00	0XN000000001
11111111111111111111
