NO test_artifacts/valid.xpm
SO test_artifacts/valid.xpm
WE test_artifacts/valid.xpm
EA test_artifacts/valid.xpm
F 240,71,104
C 183,23,52

11111111111111111111
1000000 000	0 0 0	01
10X00000000000000X01
100X0X000	0000000 01
10	00000	000	0X00001
10X00000 00X00000	01
100000000000 0000 01
1000	0000X00000X0001
10000000000 0X00	001
1 0000000X0000X00001
100 0	000000000X	 01
100 000	0	0000000001
10000X000000 00X0001
1 00X000000X00000001
1 X000000X000	000001
100X00000000000X0001
100000000	0X00000X01
1000000	0 0000000001
100000X 0	000N000X01
11111111111111111111
