NO test_artifacts/valid.xpm
SO test_artifacts/valid.xpm
WE test_artifacts/valid.xpm
EA test_artifacts/valid.xpm
F 60,70,49
C 175,89,79

11111111111111111111
100 00X	00 X000X0001
10000X00000000000001
1 0X0000000 00 00001
1000X00 00	000 0X0 1
1000X 0000XX 0X00	01
100 	000000000000  1
100000 0X0 0 00N 0 1
100000	0000000 0 0X1
10000X000000 0X0X0X1
100000 00X000X 00001
100000000 000000 001
1X00	000000000  0001
1000X00 00000X0  001
1000 0		000000 00001
10000	0X00X	0 000001
1000	00000000000 X01
10000000000  000	001
1 X00	0	00X000 00 01
11111111111111111111
