NO test_artifacts/valid.xpm
SO test_artifacts/valid.xpm
WE test_artifacts/valid.xpm
EA test_artifacts/valid.xpm
F 175,,0,0
C 25,90,173

11111111111111111111
1000X0000X000  00001
10	X00000000X000X001
100	0	0	0X0	000000X1
10000X00 00X000X  01
1  00000000 0000 001
1000000 000 0000 001
100000  0X0000000001
1 X 0000000000000001
100	000 00000 	000X1
100 000N00 0000  001
1	000XX0000 00000	01
1000X0X000X00000X001
1000000000000000X0 1
1000X0 0 0000000X001
10 00	X0000000000001
100 00000000 0000 01
10000 00X000X00000 1
1	00 0 0000000000001
11111111111111111111
