NO test_artifacts/valid.xpm
SO test_artifacts/valid.xpm
WE test_artifacts/valid.xpm
EA test_artifacts/valid.xpm
F 78,,0,0
C 218,72,202

11111111111111111111
100X0000 X00 X000 01
10000 000X00  000001
1000000	0000X	00X001
10000000000X00 00 01
1 0	000000 0000X0001
100000	000000000	0	1
100X000 00XXX 000001
100000000  0000	00 1
1000000000 00 000001
1000000000N00X0 0001
10X0000000000000X 01
10000 0000X00 00 0 1
10000	0X0000000X00 1
10  	0	00 000X00 X01
100 000000X0000  001
1	X00	000000 00X00	1
1000 XXX 0000000  01
1000000000X0	00X0X 1
11111111111111111111
