NO test_artifacts/valid.xpm
SO test_artifacts/valid.xpm
WE test_artifacts/valid.xpm
EA test_artifacts/valid.xpm
F 39,167,100
C 38,238,100

11111111111111111111
10110010000000001111
10000010000010100101
10010000000000000001
10010000000000100001
10001000N00011100001
10000000000000000101
10100110000000100001
10000000001100000101
11000010001000000111
10001000100000001111
11000010000000000011
11000000000101100101
10100000001010001101
10001000000001000001
11001000101010100001
10100000000100100001
10100000000000001001
10000000010000100001
11111111111111111111
