NO test_artifacts/valid.xpm
SO test_artifacts/valid.xpm
WE test_artifacts/valid.xpm
EA test_artifacts/valid.xpm
F 95,119,220
C 230,238,111

11111111111111111111
1	00 0	00X0000000	01
100 000000	0 0X00001
1  000000000	00000X1
10000000X0 X0000X001
10000X0 0  N000000X1
1	000	0X	 0	00000001
1  0XX0 00XX00X X0 1
100000 0000000000001
10000000000000000 X1
10	0000X 0  00000001
1X0X0000000000 000 1
1000  X0000 00000001
100 0 X000 000000	01
1X0000000 00X 000001
100000000	000000X	01
10  X00000000000X	01
10000000000000000001
1000000000X0 X000001
11111111111111111111
