NO test_artifacts/valid.xpm
SO test_artifacts/valid.xpm
WE test_artifacts/valid.xpm
EA test_artifacts/valid.xpm
F 214,186,254
C 14,136,55

11111111111111111111
1000000 X00 00000 01
100 000X0000XX0 0001
100000000000X00000X1
1	 0	0000000XX0 0 01
100 	00 0000 000X001
100 000000 X0000 001
10000 00	0000	 X0	01
1000000 000000000001
1 00000000	00 000	01
1000000X000000000 01
10X0000	000X00	X00 1
100000 0 0	X00000001
100 00000X0N000000 1
10000000	0 	0 000001
10	0000 00000X X0001
100  X0000000000 0X1
1 0000X	000000000001
100X0X00X0 00000X001
11111111111111111111
