NO test_artifacts/valid.xpm
SO test_artifacts/valid.xpm
WE test_artifacts/valid.xpm
EA test_artifacts/valid.xpm
F 187,19,242
C 38,244,94

11111111111111111111
1	00	00	000X00X00X01
10 00 	X0 0000N00X01
1000X0 000000X00	 01
10000000000000 000X1
1000 000000000 X0 01
10000X000000 0000001
100XX0 0000X0000 001
100	00000XX00 000	01
1000X00000 000000001
1000 00	0 0	X00	0 X1
1000000 0X0X0	0X0001
100X0 000000000000 1
1 0XX0X0000000000001
1000000000 000 00001
1000X000 0	000000001
1000 0	000X00 0 	001
10000 0 0	000X000 01
1 	0000X0  000000001
11111111111111111111
