NO test_artifacts/valid.xpm
SO test_artifacts/valid.xpm
WE test_artifacts/valid.xpm
EA test_artifacts/valid.xpm
F 85,239,110
C 252,132,57

11111111111111111111
11000001000000000011
10000001000000001001
10101000010101000001
10010000000100000001
10000011000001100011
10010000000001100101
10000000101010100001
10011000000000000001
11100010100000000001
11000000100000000001
100010N0000000000011
10010000001100010001
11011000000000000101
10100010001001000001
10010000000010010001
10001000000000100001
11000011000000001001
10000000001000000001
11111111111111111111
