NO test_artifacts/valid.xpm
SO test_artifacts/valid.xpm
WE test_artifacts/valid.xpm
EA test_artifacts/valid.xpm
F 151,216,65
C 139,93,99

11111111111111111111
1  0  00000000X0 X01
10000	0000XXX 0X0001
1X00000 X00  0 000X1
100 0X000	0X000XX0 1
1	0 XX000000X 000001
100 000 000 00 0X001
10000 0 0000000 00 1
1000X 0X000	0000X0	1
1 000 0X000000000001
1000000000X00 000001
100000000	000  00001
100 00X00	000000 0X1
1 0000	000 0X 00X	01
10X0000 000 000000X1
1X0N  0000 0	0	0X001
1 0 000000	0 00 00 1
1000000XX0X000 00001
1 00000000 00X000001
11111111111111111111
