NO test_artifacts/valid.xpm
SO test_artifacts/valid.xpm
WE test_artifacts/valid.xpm
EA test_artifacts/valid.xpm
F 153,130,91
C 23,169,196

11111111111111111111
10000100000000000001
10000011100000000001
10000001110000010011
11100000001000101001
10000100000000000001
10000000100011011001
11100101000000100101
11100000100000000001
10000000000010000001
10000100010000000001
10001001010000100001
10000001001100011001
1000010010000N001001
11000000110000000001
10110001000100001101
10010000010001011001
10001001000110000001
10001000010100000001
11111111111111111111
