NO test_artifacts/valid.xpm
SO test_artifacts/valid.xpm
WE test_artifacts/valid.xpm
EA test_artifacts/valid.xpm
F 79,61,64
C 122,44,22

11111111111111111111
1	0X00X000  X00X0001
10000X0000N000000001
100000	00 X000 	X001
1000X00X00000000 001
100000X000 0XX00 001
1000000 00	X000	0001
1X00  XX0000000	0X01
100 0000 00	00000001
1XX000X000	0000X0001
1X0 0X0X000000X00001
10 0	X00000 0 000001
10X00000000  000 001
1XX00 	000000	000001
10000XX000 0000 	X01
1000XXX0X00000000001
100	00X00000000000X1
10000000X00000000001
10000  0000000000X01
11111111111111111111
