NO test_artifacts/valid.xpm
SO test_artifacts/valid.xpm
WE test_artifacts/valid.xpm
EA test_artifacts/valid.xpm
F 205,209,229
C 118,135,90

11111111111111111111
1X0	000	000  0 X 001
1000000000X0X0X0 001
1000000X0XX0X00 0X01
10	X	0X00000 0X00	01
1 0 000 0000 00X 0X1
1 0X00X00 0000000 01
1N	0000000 0000XXXX1
1XXX 000000000X	0X01
1 00X 0	0	X00XX 0001
1	000 00000000000X01
10000000X0 0000X0001
10000000000000000001
10000000000000000001
10X0000000XX00 00 01
10 0X0X0	00  0000001
1000000000000 0X0X01
100X00000 X0X 0X	001
1000 000000X	XX00001
11111111111111111111
