NO test_artifacts/valid.xpm
SO test_artifacts/valid.xpm
WE test_artifacts/valid.xpm
EA test_artifacts/valid.xpm
F 30,,0,0
C 134,80,203

11111111111111111111
100X	000X	00000	X001
1	00X000X000000 0 01
100 00000X00  X00001
10X   000000000000	1
1000000		000	0000X 1
100	0 000000 00000X1
100	0000000000000001
100000000000X 00X 01
1X0 00  00X000000001
10X00	0000X000000	01
10000 0X0X00X	X00001
1X0000X000000X0X0X 1
10	00X0 00 00X0 X001
10000N0000X0  000001
100000X0000 0000XXX1
1000X0 00X00 0XX		01
1 0	0 0	0 XX0000 001
10	0X 0000 0000X0001
11111111111111111111
