NO test_artifacts/valid.xpm
SO test_artifacts/valid.xpm
WE test_artifacts/valid.xpm
EA test_artifacts/valid.xpm
F 7,181,7
C 93,139,173

11111111111111111111
10000000110000000101
10000000010000000001
10100001000010000001
11000001010100000001
10001001000001010101
11001000100100100001
11010000000000001101
10000000000101000001
10001001110000000001
10000000000000000101
11000011000001000001
10011010010101000111
10010000011010000001
10000N01000000000001
11000000100001100001
10000000010011000001
10110000000000000001
10000110101110000001
11111111111111111111
