NO test_artifacts/valid.xpm
SO test_artifacts/valid.xpm
WE test_artifacts/valid.xpm
EA test_artifacts/valid.xpm
F 225,163,197
C 133,54,51

11111111111111111111
10001000000010000011
10010000000000000001
10000000010000000001
11100001000000000001
10000001000N00110011
10110100000001000001
10001010001000001101
10100001010001110011
11000001000000001001
10000100010000011001
10000000000000000001
10000100000010011011
10000000001000010001
10101010000000010001
11001000011001100011
11000000000011100011
10000000100100000001
10000000000000000001
11111111111111111111
