NO test_artifacts/valid.xpm
SO test_artifacts/valid.xpm
WE test_artifacts/valid.xpm
EA test_artifacts/valid.xpm
F 171,209,151
C 97,234,56

11111111111111111111
1		00X0 0000X0000001
100X000000	0X0X00001
10	00000000000 000N1
100X0 X0000000 000	1
1000X0 00X000X0000 1
100000000	00000 00	1
100000000000000X0001
10000 000000000000 1
1000000 0000XX000001
100 000000X	0XX000X1
10 000X	0000X0000X01
100000X0000	XX000	01
1 000000 0000000X001
1000X000000	X0 00001
1 0 0000		0	0X0 0001
100000000000000	0X 1
10 0000X	000000000X1
1000000000000X0	0XX1
11111111111111111111
