NO test_artifacts/valid.xpm
SO test_artifacts/valid.xpm
WE test_artifacts/valid.xpm
EA test_artifacts/valid.xpm
F 229,39,8
C 254,72,187

11111111111111111111
1 00 00 000X0X000001
1000X000000000000001
100XX0	0000XX0000001
1 00000		000X	X000	1
10X00 00X0 000000001
1000X 0X00000	00 001
10000X 0X000000X	0 1
10 X00 000000000X001
100000XX000000X00001
1 00000 X0 00 000X	1
1000	000000	00000 X1
1N	000 000X  00X0001
1000X00 0000X0X00 X1
10000X00000000	00	01
1X000000 000 X0X0001
1X000000	X0X	0000001
1000000000X	000X00	1
1000	000000000000001
11111111111111111111
