NO test_artifacts/valid.xpm
SO test_artifacts/valid.xpm
WE test_artifacts/valid.xpm
EA test_artifacts/valid.xpm
F 49,253,63
C 114,51,116

11111111111111111111
11000101010001000011
10000010000000000001
10111100000100001011
10110100100100010001
10001000001000000001
10000000010000100001
10000100000000000001
10100011000011000001
10011000000000000111
10001000000001000001
1001010N000000000101
11010000000010000001
10001000100000000001
10000011000101010001
11000001000000000001
10001100100000000001
10010000101000000001
10010100100011100011
11111111111111111111
