NO test_artifacts/valid.xpm
SO test_artifacts/valid.xpm
WE test_artifacts/valid.xpm
EA test_artifacts/valid.xpm
F 7,54,247
C 30,99,196

11111111111111111111
10 0 000000000000001
100000000000X00  001
100000000 00 00  001
10 00000000000000001
10000000000 000 	0 1
100 00000000000 00 1
100X0 00000000000X01
10	00 X0 000000000 1
10X00X0X00X 00	0	X01
10 000X00X000	000 01
1 00XX	00 000 0000X1
1000X 0X00X 0000X001
1000000	0X000	X00 01
1000X 000000		0	 0 1
1XN00X00  X0000	X001
10	0		0	000X000	0001
10 00000000000000001
10000000000 00X0	0 1
11111111111111111111
