NO test_artifacts/valid.xpm
SO test_artifacts/valid.xpm
WE test_artifacts/valid.xpm
EA test_artifacts/valid.xpm
F 114,49,249
C 239,24,160

11111111111111111111
11000010000000000001
10010000000010100001
10000101000100100001
10000010011000100011
10000000000101000001
10000000000000101011
10110010000011000101
11001010000000001001
10100011000010000011
10001100000000000001
10001010000000000101
10001001001000000001
10000000000000000001
101110001101000N0001
10000000010001000101
10000010000000000101
10000000101000100011
11000001000100000001
11111111111111111111
