NO test_artifacts/valid.xpm
SO test_artifacts/valid.xpm
WE test_artifacts/valid.xpm
EA test_artifacts/valid.xpm
F 231,,0,0
C 215,72,30

11111111111111111111
100 000000 00000 001
1XX0  	000 X0000 001
100		 0 000000000001
100000X000 000000 01
1X000000 0X0XX0 X 01
1	 X000000000 000001
10X000000 0X0 000001
100 0	0 	0000000N	01
10 0 00000 0000X00 1
1 X00	 00X00	00000 1
1	000 X000000000X0 1
10  0000000000X00001
1 0X00X00 0000000001
10000000 000X00X0001
100 	0000000000X 0	1
1X0X000000X00	0000 1
1 0000X00000X00	0001
100	0000X0  X00  001
11111111111111111111
