NO test_artifacts/valid.xpm
SO test_artifacts/valid.xpm
WE test_artifacts/valid.xpm
EA test_artifacts/valid.xpm
F 98,26,16
C 22,246,30

11111111111111111111
10000100010100000001
10000110100000000001
10000000100000100001
10100000100001000001
11010001001000000001
10000001000000000001
10000001100100000001
10000N00000000000101
10000000000001000101
10000001000001010011
10000000100000001001
10001101000000000011
11010010010000000001
10000100000001110001
10010000101000000001
11000000011100000111
11000000001010000001
10001000010000100001
11111111111111111111
