NO test_artifacts/valid.xpm
SO test_artifacts/valid.xpm
WE test_artifacts/valid.xpm
EA test_artifacts/valid.xpm
F 243,233,156
C 149,154,47

11111111111111111111
10000X000XX00  X00X1
1000 0X0X0X0000000 1
1000000X00000 00 001
10	0X0000 X	0X0000 1
1000X0	00000000X0001
1 0 000000 000	00001
1X0000X0 0 00	00	001
1000000000 00  00001
100000 0000	00 XXX 1
100  000N0000000 001
1 00000000000 0 0 	1
1 0X0X0000000X00	001
100X000000000000	X 1
1X000 000000X0000001
10 0000X0X0000000001
100000	X0	X000 00X01
1000000000 0 X00 0	1
10X 0000000000000001
11111111111111111111
