NO test_artifacts/valid.xpm
SO test_artifacts/valid.xpm
WE test_artifacts/valid.xpm
EA test_artifacts/valid.xpm
F 244,253,161
C 79,83,240

11111111111111111111
10X0000X000000X 0001
100 000 0000000000 1
1000X0X0	00000	000 1
1X0  00	0000	0000001
1 00000X00000  0	0	1
1000000X 000	00 0 X1
1000X	XXX0X00 000001
10X	0	XX00 0X000 001
1X0X0000X0000000 001
1 00000000X000N0 001
1 00X0000 00000000X1
1000X000000000000001
100 X0000000 000XX01
10X 0	0 00000X000X01
1 0X00000     000	X1
100000000000X0X0  01
10 0  	00000000 0 01
10  00000X000X000	X1
11111111111111111111
