NO test_artifacts/valid.xpm
SO test_artifacts/valid.xpm
WE test_artifacts/valid.xpm
EA test_artifacts/valid.xpm
F 144,228,55
C 76,229,109

11111111111111111111
1000000 000X 0  0 01
1000	00000000	 0	0X1
1	X000000	00X 0X0001
10000000000	000000	1
10X00000 	0X  000001
100 	0000 0X00000	01
1 0X000000X00  00001
1000	000X  00 000 01
100000 	000	000000X1
1X000XX00	0	00000001
10	000	0000000	0 0 1
100000X0 00000 00N01
1000000 000X 0	X0 01
100000X 00	 0X000 01
1	0X 0X00000000000 1
10000000 00000	0XX01
10000		X0		000	00001
100	00000 000 00X	01
11111111111111111111
