NO test_artifacts/valid.xpm
SO test_artifacts/valid.xpm
WE test_artifacts/valid.xpm
EA test_artifacts/valid.xpm
F 15,81,25
C 140,165,64

11111111111111111111
10010100000000010001
10000000000000000011
10100100000010000001
10010100010001000001
10001000000100001001
11110100100011000111
10000010000110000001
10000000010000000001
10000001100010000111
10100100000000001001
10001001000000010011
10000110000100000001
11000000000000000001
11000110000N00000001
11000000000000000001
10010000000001000001
11010000010000011101
10011000000000000111
11111111111111111111
