NO test_artifacts/valid.xpm
SO test_artifacts/valid.xpm
WE test_artifacts/valid.xpm
EA test_artifacts/valid.xpm
F 189,247,92
C 110,168,86

11111111111111111111
10	X0000000X00000001
10000000000000000X01
1000 0X0000000000001
10X00	  0000X00X0001
1X 0 X 000	00 000X01
1000000N000XX00000 1
100000 0000X00000001
10000000X0	000000X01
1X	00X00 0	000000001
10000 0000X00	000001
1	0000X0 X00000X0001
10X0X	00000000 	0001
1 00000000X 00000001
1000000 000	00 0 001
1000000000XX00000001
10 0 00 000000 000X1
100X0000000000 X 001
1000000000	000000X01
11111111111111111111
