NO test_artifacts/valid.xpm
SO test_artifacts/valid.xpm
WE test_artifacts/valid.xpm
EA test_artifacts/valid.xpm
F 114,153,20
C 197,141,8

11111111111111111111
10XX00000X0 0000 0X1
10	000 0000X00X 0001
10000X0000X	0 000001
1  000	 0000 0 0 0X1
10000 00000X0000X001
100X0000000 000 0001
100X000000	00X000001
1000 00000	000 X0N01
10000000 00000000001
10000 00000XX00X0 01
1000	000	0X00 000001
1 0	0 00	000000	00 1
1 000 0X000X0 0 0001
100X00000 00000XX001
100 0 00X 0X 0000001
10000000000X00000001
10000000  00 0	00001
1X0	00	0000 0X0 0001
11111111111111111111
