NO test_artifacts/valid.xpm
SO test_artifacts/valid.xpm
WE test_artifacts/valid.xpm
EA test_artifacts/valid.xpm
F 214,157,66
C 253,198,157

11111111111111111111
10010000100000000001
10000000000000000011
10000001000000011001
10000000001000110001
10010000001000000011
11000000000000001001
10011010000010000001
1011000000N000000011
10101000100000000001
10110000000000000101
11010000000000100001
10000000101000000011
10000000010000000011
10000001010000000011
10000001000000100001
10000100010010001001
10100001000011000001
10000001000000110101
11111111111111111111
