NO test_artifacts/valid.xpm
SO test_artifacts/valid.xpm
WE test_artifacts/valid.xpm
EA test_artifacts/valid.xpm
F 141,43,207
C 133,249,152

11111111111111111111
1000	000	 0000000001
100000X00000000 0001
1 00000 0	000 X00	01
1X0	00X0X0000 000001
10 0000 X0 00XX0	001
1000000X000	 XX0X001
10X	000000 X0X00	 	1
1000000 000000	 0	01
100X0XX0000000	00 01
1X00X0 000 000000001
10	0 00000000 0 0001
1	0000X0000000000001
1000XX00 XX0XX0000X1
10X 	000000	0X00X  1
100X0X00	00000	N00 1
100000 00X000000 001
100 0 0 00X000000001
10	0 000000000X000X1
11111111111111111111
