NO test_artifacts/valid.xpm
SO test_artifacts/valid.xpm
WE test_artifacts/valid.xpm
EA test_artifacts/valid.xpm
F 21,79,134
C 117,202,8

11111111111111111111
10001011001010110001
10000010000000100001
10000000001000001001
10000000000000010001
11000000000000001001
10100100000011001001
10000100100000000101
10100000000000000111
10000000000011001001
110011010N0001001001
10000100000011001001
10011000001000000001
10110000000010001001
11000110001000000101
10000001100000000011
10000001000000110001
10101000100100000101
10000000011001011001
11111111111111111111
