NO test_artifacts/valid.xpm
SO test_artifacts/valid.xpm
WE test_artifacts/valid.xpm
EA test_artifacts/valid.xpm
F 149,,0,0
C 119,103,200

11111111111111111111
10000000000000000 X1
100000000000000X00 1
1X0X000X000000 	00X1
10000X 00000000 0001
100X0000000000000001
10N000000	000X0X00	1
1000000000X000000001
1  000X0 X0000000X01
100X0	X00000	0000001
1 X0000 0000 X000001
100	0 0 000000 00001
1000X0X00	000000X001
1 0000X000000000X0 1
100 	0000	00X000X001
1	0000 000 0 0000001
1000 000 X000000X001
100000000000000	 0	1
1000000X0000 00 0001
11111111111111111111
