NO test_artifacts/valid.xpm
SO test_artifacts/valid.xpm
WE test_artifacts/valid.xpm
EA test_artifacts/valid.xpm
F 37,203,32
C 83,83,79

11111111111111111111
100000X0X00000000  1
10X00000X000 0 X00X1
1X000 0X0 X0000 0001
10	XX	0X00 0	0 0X001
10000X00  	00000 001
100X00 	000000 00X01
1000X00000000000	001
10000000	000 X0000X1
10000	0XX0	000		0	 1
1X000000 0X00000X0 1
10000000 000	00 00X1
100000X X00	XN0X00	1
1X000000	0000	 00 01
10	0000XX0X000000X01
10000	000 0 00000001
10X	 X0X0000X 0000	1
10X00000000000000 01
10X0 0XX0 X0	0 X0 01
11111111111111111111
