NO test_artifacts/valid.xpm
SO test_artifacts/valid.xpm
WE test_artifacts/valid.xpm
EA test_artifacts/valid.xpm
F 204,36,11
C 19,0,104

11111111111111111111
1 0	00X 000 X0X00001
10000X00X0   00X0X01
1000XX00000 0X0	0001
100000X0000 	X0  001
1 000 	0  00000	00 1
1000N0000000000 0 01
1 0X 0XX0X0000000001
1000 00000	00	X00001
100000X0000000000 01
100000X00	X00X0X0001
10000 00000	000 00X1
1000 00000X000000	01
1000	00 0 0000X00001
10000000000	0000 X01
100X00			X00X0X00 01
10	X00000 0	00000001
100X00000000X0000001
10XX 0000000 0	00001
11111111111111111111
