NO test_artifacts/valid.xpm
SO test_artifacts/valid.xpm
WE test_artifacts/valid.xpm
EA test_artifacts/valid.xpm
F 238,12,42
C 162,105,91

11111111111111111111
10000000000X0000X001
1 00 000	00000	X0X 1
1000	 X0000000000X01
1 000000000000 0X001
100000X0 	0000XX 001
10000	00 0X00 000X01
1 00X 00	0000 000001
10000 	00000 00	0001
10000000 00000000001
100 0 0XX0000000 0 1
1	00000N000 X00000X1
10X 0		00000000000 1
1X00	00 0X0	0X0 0001
1 00X00 00000000X001
1X00000 	X0000XX0  1
10 0 0000000X	000 01
1000	000000000000001
1000000000000000 001
11111111111111111111
