NO test_artifacts/valid.xpm
SO test_artifacts/valid.xpm
WE test_artifacts/valid.xpm
EA test_artifacts/valid.xpm
F 237,221,232
C 20,72,174

11111111111111111111
10101000001000101001
1000000N000010101001
10000000000011000001
10000000001100000001
11011000001000110011
10000111001000000001
10100000000001000001
10100110100000111011
10010110010100000001
10000000000000100101
10000100001000010101
10001000000001011101
11100000000100000001
10011000011000100001
10011100000000000011
10001010010000000001
10000011101011100001
10110110000001001001
11111111111111111111
