NO test_artifacts/valid.xpm
SO test_artifacts/valid.xpm
WE test_artifacts/valid.xpm
EA test_artifacts/valid.xpm
F 199,0,0
C 183,105,143

11111111111111111111
1XX000000X0000000 01
100000X 		00 0 000 1
1000000XX00000 00001
1000X00000X000  00 1
1000000XX0X00  0 001
1000X0000000000000	1
10	000	00X	X00000	X1
100000000000	00X0001
1000X 0X00X000 000 1
100X 00XX 0000000001
1 	00000X00	00 X0001
1 00X00000 0XX X0 01
1000X00000X00N00 X01
1000000 0 0	00000001
1X0X XX00X 0000000 1
10000X 0X000X	00X001
10000	XX  000XX0 001
10X0 000000 00000		1
11111111111111111111
