NO test_artifacts/valid.xpm
SO test_artifacts/valid.xpm
WE test_artifacts/valid.xpm
EA test_artifacts/valid.xpm
F 73,0,0
C 197,116,190

11111111111111111111
100000 0000 00	00001
10 0X0000 0X0 X00 01
1000X000000X00000001
10000	0X 0000 X00001
10000000000000000001
100X 00 0000X00 00X1
1000 X000000X 000  1
1000 00	000000000 01
1X	00	00000 0000X 01
100	0 000000 0000	01
100000000000000 0X01
1X 0 0 00000	0000XN1
1	000X00000000000	01
10000 0000000 00 001
100	000X	 0X0000 001
10 000X0000000X0 X01
1 00000X0 00 0000001
1000000XXX 000 00001
11111111111111111111
