NO test_artifacts/valid.xpm
SO test_artifacts/valid.xpm
WE test_artifacts/valid.xpm
EA test_artifacts/valid.xpm
F 219,41,111
C 16,46,41

11111111111111111111
10000001011000000101
11100000001000000101
10001010010000000001
1000100101110000N001
10010100010000000001
11100011010000000001
10001001000100001001
10001100000000000001
10100100111000000001
10000000001000010001
10000000100000010101
10000100010000001011
10000100111000010001
10000001000100101101
10000000001101001001
10000100010000000011
10000000010001000001
10000000000000000001
11111111111111111111
