NO test_artifacts/valid.xpm
SO test_artifacts/valid.xpm
WE test_artifacts/valid.xpm
EA test_artifacts/valid.xpm
F 117,73,236
C 0,28,159

11111111111111111111
10000 0000	0X	00	001
1X00000000X	0000X001
1000000X000000XX0001
10000000	000 00 0	01
10000 00X00000000001
10000X000X 0 000X  1
10 0	00000X00		000 1
1X 00000000000X0	001
1 0 0X000	000000	0X1
100X  00 0 00X00 X 1
1	0000X00X000 X00001
1000	0	00000	000	001
1XX0X00000XX0000X0	1
10	0000X00 0000000X1
1000 00X0  0000X0001
10000 X00	000	 00X01
100000X0	0	0 000 N01
1 000 00X000X0X00001
11111111111111111111
