NO test_artifacts/valid.xpm
SO test_artifacts/valid.xpm
WE test_artifacts/valid.xpm
EA test_artifacts/valid.xpm
F 142,,0,0
C 78,202,38

11111111111111111111
100X0000 00XX	000	01
10000000000000000001
100X	0000 00	X X	001
100 0X0 00000000 001
10	00000000	00000X01
1X00000X00000000  01
10 000X 0X00 0X 0001
1000X0000X00000 X001
100000000N00 0000001
10000000000000X0 001
1	00000000	0000XXX01
10000 00000000000001
10X00X0 0X000XX00001
1000000  0000X000001
100X0 00000	000 0	01
10000000	0 00	0 XX01
1000000  X 0000 00	1
1000000  00 000X00X1
11111111111111111111
