NO test_artifacts/valid.xpm
SO test_artifacts/valid.xpm
WE test_artifacts/valid.xpm
EA test_artifacts/valid.xpm
F 14,223,203
C 106,217,26

11111111111111111111
1X0	0000000	00000 01
1000000X0X0000000001
1000X00000	000000	01
100 0 000000X 0 00X1
100 00000X0X00	000X1
100000000000   0 X01
100	0	00000000000001
1000000XX0X000000X 1
100 000X 00000 0X 01
1000000000X000000001
1X00000000	  000 001
10X0000000000000 001
100 00 000 000000001
1 0 000	00000 000	X1
10000N	XX00000000 01
100000	00	00 000 001
1X0000X0000	0000X001
1000000 000000000001
11111111111111111111
