NO test_artifacts/valid.xpm
SO test_artifacts/valid.xpm
WE test_artifacts/valid.xpm
EA test_artifacts/valid.xpm
F 204,179,39
C 251,250,86

11111111111111111111
1 000000 0X0000X 0	1
1 X X000 0X000000001
1X00000X000000000 01
100  000 0000 X 	001
100000 0X0 0 0X0X0 1
10X00000X0000 0X0001
1000X0000000000 0001
1 00X0 0000000000001
1000000000000000 001
1	00000000	X0X 00001
100N0X00X000000 0 01
100  	0000X000000X01
100000000X00	00 0X01
100000 0000X000XX001
100X00X0000 0 00 	01
10000X0000000 000001
1	00000  0		0000	X01
1000 0 000 000	0 001
11111111111111111111
