NO test_artifacts/valid.xpm
SO test_artifacts/valid.xpm
WE test_artifacts/valid.xpm
EA test_artifacts/valid.xpm
F 214,44,108
C 106,210,78

11111111111111111111
100000000	XX 0000X01
1000	00	00 0X000 	 1
100000 0X0000000XX01
1000X	00000 00000X01
1000X0	0 0X000	00001
10	 000000X0000000 1
1 0 0000000X00000001
10000 0	0 0000 00X01
1	0000  000	000000X1
10	0	00000 00	000001
100000000000X		00001
1000 0000X 0X0 000X1
1000000000000000X001
100000000000 X 000 1
1000 00 0	0000 00001
100 0000000000000001
10 XX	000000X00XN001
10 0X00	0000 X0X00 1
11111111111111111111
