NO test_artifacts/valid.xpm
SO test_artifacts/valid.xpm
WE test_artifacts/valid.xpm
EA test_artifacts/valid.xpm
F 139,0,0
C 23,215,190

11111111111111111111
10000000000	00XX0X01
100 0 000000000 0001
1	XX000	00000000 001
1X00	00000 000000001
1X00000000000X0000X1
100 00000000000  0X1
1 0X00000000X0000001
1 0000X0000	00000  1
1 00  000000X0X00001
100000X000XN0000 001
100	00000X 000000 X1
100000000000X00000X1
1000 00X0000000 0 01
1000X000X0000	0X00X1
10 00	0XX0X0000 X0X1
1	 00X00XX0000000001
100X0000000000000001
100000X000	000000001
11111111111111111111
