NO test_artifacts/valid.xpm
SO test_artifacts/valid.xpm
WE test_artifacts/valid.xpm
EA test_artifacts/valid.xpm
F 113,146,233
C 231,79,46

11111111111111111111
1 0 000 	0000000	0N1
1000000 00000 000	 1
10000000X0000X000X01
10X0	000XX0X0X	0 001
100 	0000	0000000001
10 00000X0000000X001
10000X0000X00 0X 001
100X0	0000	00 000X01
100XX0X000 000X0 001
10 X000X000X0 00 0	1
100X000X00	0000000X1
10000X000 	000000	01
100000000	00X0000001
10	000000000X00X 001
100000 0  0000X  	01
1X0000000X00 00000X1
100000000X00000 0001
10000000 X0000X0X001
11111111111111111111
