NO test_artifacts/valid.xpm
SO test_artifacts/valid.xpm
WE test_artifacts/valid.xpm
EA test_artifacts/valid.xpm
F 253,243,156
C 223,204,15

11111111111111111111
10001010110000000111
10000100000000110101
10000010000000000001
10001000000100001111
10001011000000110001
10000100000000010001
10N00001000000100001
10001000000000000001
10000011000000000001
10000100000010101101
10001100000000000001
11001000001000000001
10000000001000100001
10010001000000000001
10000001000110011001
10000010000000001001
10001000100000001001
10100000010100110011
11111111111111111111
