NO test_artifacts/valid.xpm
SO test_artifacts/valid.xpm
WE test_artifacts/valid.xpm
EA test_artifacts/valid.xpm
F 143,224,253
C 84,221,146

11111111111111111111
10010000000000010001
1000011110000N001001
11010100000000000001
11100100010000110001
10000010101000100001
10001100000000000101
10001001000001101001
10101000000000001101
10100101000000000001
11101000000101000001
10010000000110000011
10000100000000100001
10000100000001000101
10100000000100100111
10001010110000000001
10000001000000010001
10001110100000000001
10000100000000000011
11111111111111111111
