NO test_artifacts/valid.xpm
SO test_artifacts/valid.xpm
WE test_artifacts/valid.xpm
EA test_artifacts/valid.xpm
F 48,112,135
C 9,49,222

11111111111111111111
100 0 00000000X X0 1
1 0X0000 000X000X0 1
1000  0000X000000	01
100000000X00000X00X1
100000 00000000 0001
1000000000 0	XX00001
100 00XX00 	00X0 0X1
1000X X0000000000 01
10000000 000000000 1
1X00  0X000000X00N 1
10 0000X 0X0 X000001
10000000000X00000001
100000000	0000000	01
1000000X000000 00001
100000000 00XX000001
1000000000 00 0XX001
100 	0		0 00X00 0001
100	0		000X000000	 1
11111111111111111111
