NO test_artifacts/valid.xpm
SO test_artifacts/valid.xpm
WE test_artifacts/valid.xpm
EA test_artifacts/valid.xpm
F 41,216,220
C 110,66,100

11111111111111111111
10000001010001000001
10000001010100110001
10101000001000010001
11000000010011000101
10000010001001000001
10010000000000010011
100101000N0001000101
11000000000001000001
10000100000000000101
10000010000010001101
10100101000000000011
11000010000001100001
10000001000101000001
10110110100000000001
10000000001000000011
10010001000110000001
10000100000000100101
10000000010001001001
11111111111111111111
