NO test_artifacts/valid.xpm
SO test_artifacts/valid.xpm
WE test_artifacts/valid.xpm
EA test_artifacts/valid.xpm
F 4,53,146
C 91,101,11

11111111111111111111
10100000010010011101
10000000000010100011
11000101000000010101
10100010101100011011
11001001100000100001
10000000000N00000101
10000000000000000001
10000101010001000001
10100000100000011011
10000000100000010101
11000000000001000011
11000100000100010001
10001000010000001001
10000000000000000101
10000000000000100001
10010010000010000101
11000001001000000101
10001000000011010011
11111111111111111111
