NO test_artifacts/valid.xpm
SO test_artifacts/valid.xpm
WE test_artifacts/valid.xpm
EA test_artifacts/valid.xpm
F 255,57,159
C 97,199,89

11111111111111111111
10100100001000011001
10000000000100011001
10101000010010000001
10000000000100010101
10010000000001100001
11010100000000000101
10000000000100000001
11001010100000110001
10000000000N00000001
10000000000001000001
10110010000001000011
10010000100000010001
10010001001100100011
10000000001001101101
10000001001000001001
10110000000001001011
11100000100000100001
10000011000100100001
11111111111111111111
