NO test_artifacts/valid.xpm
SO test_artifacts/valid.xpm
WE test_artifacts/valid.xpm
EA test_artifacts/valid.xpm
F 119,117,233
C 24,147,47

11111111111111111111
100	X000X0XX00000	01
1000X00000 000X X001
100X0X000000 0  0N01
1X000000X0 X000X 001
1X000000000000000001
10000000000000000001
10000 000X00 00000X1
1000X000 0X0000	0001
1000000000	   00 001
1000 	000 0X000 0001
100000X0000X0 000 01
100X00 0000000 000 1
100000X XX00 	000001
10 0X X0 0000	0 00X1
100000000000000 00 1
1 	 X0 000000  0X001
1  0000	X00000000X01
10X00000 0XX	0000001
11111111111111111111
