NO test_artifacts/valid.xpm
SO test_artifacts/valid.xpm
WE test_artifacts/valid.xpm
EA test_artifacts/valid.xpm
F 201,,0,0
C 54,20,224

11111111111111111111
10 000000 0000000001
10000X000X X 	00 0 1
100 0X00X0X00X000001
1000	 00	0 00000	001
100X 0X0000 0000 0X1
1  0 0 N000000000001
10000	00 0X0X0000001
1X00 0 0000 0	0 0001
100 00000XX0	000X0	1
100X0000000	0X00  01
100X00000 0000000 01
1000X00000 0000 0 01
100000000	00X00  001
100 0000000000 	0001
10000X000000 0X00X01
10X00000000000000001
10000000X00000X00001
1 X0 000X0  0000X	01
11111111111111111111
