NO test_artifacts/valid.xpm
SO test_artifacts/valid.xpm
WE test_artifacts/valid.xpm
EA test_artifacts/valid.xpm
F 137,113,239
C 39,207,47

11111111111111111111
10000	X00000000X	0X1
1000000000000000X001
10000 X0	0X000000001
1 00000	0X00000XX001
1X X000 00000X00	001
10X0	0X0X00000X00001
100000000XN0	X0 0001
100 0 00000	0000X 01
100X0X000000	 000001
1 0 00000000000	0001
10000X0000X00X000	X1
1 000 000000 000 0 1
1 00000	0000	0000001
1 0000000X000000 001
10X00000000X0000	001
100000000000	00 00	1
10000000000	X00X0001
100X000000	00 00 0 1
11111111111111111111
