NO test_artifacts/valid.xpm
SO test_artifacts/valid.xpm
WE test_artifacts/valid.xpm
EA test_artifacts/valid.xpm
F 22,109,78
C 203,4,121

11111111111111111111
100000	000000 000001
1X X0X00000 00X00 01
100 0 0000 00000X001
1 000000000 00	00N 1
1000X00	000000000X01
1X	X0000XX0X00 0	001
100 	00X00000 000 X1
100000	0	00000000 01
1	X0 00000000	00X001
100000X	0 00X0 00001
10000000000000000001
1 0000000	X00X000001
1000X000	 0X00000 01
1X00X00000	00000X001
1000 	000 0 000X0001
100	0 0  00 0X 000 1
10 000	0000	00000001
1 000000000000	00 01
11111111111111111111
