NO test_artifacts/valid.xpm
SO test_artifacts/valid.xpm
WE test_artifacts/valid.xpm
EA test_artifacts/valid.xpm
F 205,105,72
C 80,79,191

11111111111111111111
11000000000100000001
11000100000001000101
10010001000000000001
10000000000010001001
10100000000000000101
11011000011000110001
10000010000000000001
11001101000000110001
10010000000000001001
10001000001010001001
1100100N001010011001
10010000010100001101
10000001000100000001
10000000000000000101
11000000000110010001
10000000000000000001
10101001100000000001
10010010010000010001
11111111111111111111
