NO test_artifacts/valid.xpm
SO test_artifacts/valid.xpm
WE test_artifacts/valid.xpm
EA test_artifacts/valid.xpm
F 147,,0,0
C 22,111,109

11111111111111111111
100X00000X0000000X 1
100XX000 000000X0001
10 000	0000000000001
1X0000   0X	00  		01
1 00 00X00 000000001
1X0X00X0 00X  X000 1
100X0 X0000000000001
100 000  XXX000000 1
100000X000000000X001
10 0000 000X0000X001
1	000		 000000000001
1 X 00000000 XX00001
100000 0 0000	 00	01
1XX00	000	00	 000001
10 000X000 	00000	01
1 X000X0 000 00 00X1
1000000	 0 X00N 0001
10	X00000000 0X00001
11111111111111111111
