NO test_artifacts/valid.xpm
SO test_artifacts/valid.xpm
WE test_artifacts/valid.xpm
EA test_artifacts/valid.xpm
F 78,230,128
C 155,76,14

11111111111111111111
100000 00000	0000 01
100000	0000000000X01
1X00X 00000000 00X 1
10000000000000000001
100000 000 00 0X0001
10000000000000	0X0N1
1	0000000000000000 1
100000000000 0000001
10 00X000X0	000 0	01
100000X0 0 0000X0	01
100	000 0000 00X	0 1
1000X0000000 X 0X 01
100 0000 000000X0XX1
100 0000X000 0	00001
1  0000000XXX0000001
10X000000000X0000001
1 0000000XX00 00X001
10000X000X0000 00X01
11111111111111111111
