NO test_artifacts/valid.xpm
SO test_artifacts/valid.xpm
WE test_artifacts/valid.xpm
EA test_artifacts/valid.xpm
F 206,220,68
C 171,206,145

11111111111111111111
10000 0000	0	00 0X	1
100000 000	000000001
100 00000 00X0000001
10000 X0000 	000	001
10000	00 0 00 0X0001
10000000X00X0	0	0001
10	0X00X000000000 01
10000 0000X00X0X0 01
10X000000000X0X00001
1	000X0 X00X00	0	001
1000000000000X0 0001
10 00000X0X0X0	0 001
1000X X00000 00	0001
100  	00000X00X00001
10 0	  0 0 00X000X01
100000	0X0X000000001
10000000000	00000001
10000000000NXX00 001
11111111111111111111
