NO test_artifacts/valid.xpm
SO test_artifacts/valid.xpm
WE test_artifacts/valid.xpm
EA test_artifacts/valid.xpm
F 71,,0,0
C 40,57,126

11111111111111111111
100	 00000XX00000001
10000000X0X000000001
100000000000 00 00X1
1000X 000X0000	00 01
10000	0000000000 001
1X00000X00N  0000X01
100000	000000000X001
10000X0000X0  00 X01
100  0  000000 0	001
100000000000X000 001
1000	X0000000 000001
1	000000X	0000 00001
1000X000X00X00 0 001
10X000  XX	00 000  1
100000 00 000 000001
10000 0000000000X001
10000000000 0X000  1
1X	00	  00000000	 01
11111111111111111111
