NO test_artifacts/valid.xpm
SO test_artifacts/valid.xpm
WE test_artifacts/valid.xpm
EA test_artifacts/valid.xpm
F 43,137,55
C 189,172,2

11111111111111111111
10100000000110100001
11000000010011000001
10100001000110001001
100001010N0000100001
11010000000000001001
10000001000000000011
10000000010100001001
10010000011000011001
10000111011000100011
10010000000101000001
10000001000001100101
10000001000000111001
10100000010001000111
10000100000110000101
10000000100010000001
10000000010100010001
10000000001001010011
10001100000000001011
11111111111111111111
