NO test_artifacts/valid.xpm
SO test_artifacts/valid.xpm
WE test_artifacts/valid.xpm
EA test_artifacts/valid.xpm
F 177,234,221
C 27,107,191

11111111111111111111
1	0 	00	0000000XX001
1000X000000	00000001
100000000000000000	1
1 X 0000000X00000X01
100X0000000 XX000X01
10000 00000X00 	0X01
10   	 	0000	 000001
100 000000000000N001
100X0000	00 00000001
1000000	0000 00	0001
1	0000 00 XX0X000001
1000 000000000X00001
1000X00000X0	X000001
100	0000 0 00 0	0001
10	00000 X00000XX001
100000	0000000XX0X01
10X0 0000 0000000X 1
100000 	0 000 0000X1
11111111111111111111
