NO test_artifacts/valid.xpm
SO test_artifacts/valid.xpm
WE test_artifacts/valid.xpm
EA test_artifacts/valid.xpm
F 224,76,14
C 1,208,112

11111111111111111111
100000000000000000	1
1X00 0 0000	00000	 1
10 00000	X0000000001
1 000 X 00		 000X0X1
100000000 000 000001
10000000000000 00001
100 00000N0 0000 0 1
100X000		00000000001
10000000000	00000001
10 0X0000X 000	0X001
1000000X	0 0	0X00001
10000	000000X0X000X1
10000X	0000000000001
10 0 X000X0000000X 1
100X0X00  00000 00 1
10	0000X00X00000 X01
10	000000000000	X001
1000000000000000	001
11111111111111111111
