NO test_artifacts/valid.xpm
SO test_artifacts/valid.xpm
WE test_artifacts/valid.xpm
EA test_artifacts/valid.xpm
F 87,150,242
C 0,73,222

11111111111111111111
10000000000000001001
10010000011101000001
10000100100000000001
10000000000010100001
10000010100000000101
10000000001000111001
10000101000000000001
10000000000000001101
10000100100000110001
10000101000000001001
10001000000010000101
11110000110000000101
10000000001000000001
11000000000000000001
10010N00000010100011
10010000101001000001
10110001000010100001
10010000000010000001
11111111111111111111
