NO test_artifacts/valid.xpm
SO test_artifacts/valid.xpm
WE test_artifacts/valid.xpm
EA test_artifacts/valid.xpm
F 25,237,225
C 75,58,154

11111111111111111111
10000000010010010001
10000001010000001001
11000000001000000011
10000000000000000001
10110100000100000011
11000000000010000101
10100010000000010001
11000000000000000001
11000000000100000111
10010110000000000001
10000000100000100001
10010000000110100001
10000100000000000001
10010000000110100001
10000000001000000001
11000000100000000001
1001010001100N001001
10011000000000010001
11111111111111111111
