NO test_artifacts/valid.xpm
SO test_artifacts/valid.xpm
WE test_artifacts/valid.xpm
EA test_artifacts/valid.xpm
F 11,117,251
C 85,99,53

11111111111111111111
10111000111000000011
10000000000010000111
10000000000100010111
10100000000110000001
11000010000000001101
10001000000001100101
10000000000011000001
10000000000000100001
10001000100010010001
11100100000001010001
10010110000010000001
11001000000000010001
100000N0111110000101
10010000000110100001
11000000001000000011
11000000000000001001
11010000001000000001
10000100010000000001
11111111111111111111
