NO test_artifacts/valid.xpm
SO test_artifacts/valid.xpm
WE test_artifacts/valid.xpm
EA test_artifacts/valid.xpm
F 282,0,0
C 183,139,164

11111111111111111111
10000 0000000X	00001
1 0	00000 00X0000001
100X 00000X000000X01
1000	00000XX 0000001
1000X00000 	 0000001
1000000 0000	0000  1
100 00X000000XX00 01
1000	000	  00000X001
10 X000  0 X X00 001
1000 0000X 00	X000	1
10 0 000 	0	X0	000 1
10 0 00X 00 000X 001
100000 0X0000X00 001
1000000X00X000000	01
10N00 0X00 000 0X0X1
1000X	0 0000000X0001
10000000X00X0000X001
1 X00 X00 0000000001
11111111111111111111
