NO test_artifacts/valid.xpm
SO test_artifacts/valid.xpm
WE test_artifacts/valid.xpm
EA test_artifacts/valid.xpm
F 95,0,0
C 175,15,66

11111111111111111111
1000X 00000X00000X	1
10X 00N0000	000 00X1
100 0X0X 00000000 01
1000000000 0  0X0001
100	000000 000000	01
100 00 00X0X0X0 0001
100	00000000X0 0X0 1
1000	0 0000000000001
10000XX00000XX000001
10000		0 0000000 001
100000000X00X0X00001
10000	X0000000 000	1
1000000X0   0	0000	1
100  0000X0000000001
10000X0000X 00	0 0X1
1 00	XX	00000 00 X01
100 0X000000 0000X 1
10000000000	00000001
11111111111111111111
