NO test_artifacts/valid.xpm
SO test_artifacts/valid.xpm
WE test_artifacts/valid.xpm
EA test_artifacts/valid.xpm
F 248,191,234
C 93,116,213

11111111111111111111
1 00 000000000	00001
1 000X00000000 00001
100X0000000000  0X01
100 0X00000000X000 1
1XX00X0000X 00 XX001
100000X00000000X00X1
100	 00X0 0X000X0001
10000 000	00000	0XX1
1000000000 00N000 01
10 X0 00X00000	0XX01
1X00	 00  0X0 0	 001
1 00X000000X0XXX0001
1	0000000000000	 001
10	00000000X0000X	01
10X	00000X00		0000 1
10	X000  X000	000001
100000 X0000000X0001
100 00000	0X0X  0001
11111111111111111111
