NO test_artifacts/valid.xpm
SO test_artifacts/valid.xpm
WE test_artifacts/valid.xpm
EA test_artifacts/valid.xpm
F 175,,0,0
C 42,212,159

11111111111111111111
100 	000000X X000	01
1X000  0000000000001
10X00000 0000X 0X0 1
1 000000 00X00000001
1X00XX	000  000	0001
1000X0 0 00000 000X1
10X0	 0000000	0X 001
10X00 000000000000	1
1X  0N00 XX0 0 00001
10000X0000XXX	X00001
1000X 000  000		XXX1
100 000 00000000X001
1X0 000X000000	00001
1 00000 00	X000000 1
100	000	00000X0	0 01
100000 00000 000 0X1
1	   00 0X0X00000	01
100	00	X 0 0000000X1
11111111111111111111
