NO test_artifacts/valid.xpm
SO test_artifacts/valid.xpm
WE test_artifacts/valid.xpm
EA test_artifacts/valid.xpm
F 159,194,72
C 121,123,225

11111111111111111111
1 X00X00 000000XX001
10000	00N0		 000	001
10	0X000 00 0X00X001
10000 000000 0X	00X1
10000000000 0000 001
100	0 0X0 00X0 0X001
10 X00 00000 0000X01
10000X0	00X000 00 01
10XX00000000 0	00001
100 000	000 00 00 01
100 0	00X0	0000000 1
1	000000	0 0 0  0001
10000000000X000	0 01
1	0X000	X00X000X0X 1
1000 0000X00 X00XX01
10 0 000000000000001
1000000 00  000 0 01
1 0000000 	X00000001
11111111111111111111
