NO test_artifacts/valid.xpm
SO test_artifacts/valid.xpm
WE test_artifacts/valid.xpm
EA test_artifacts/valid.xpm
F 7,215,249
C 49,178,60

11111111111111111111
10000000 	00X0X0X001
1X000000000000X00001
100000 000	000000 X1
100	X0 0 0	0XX0 	001
10	0X00 000 0 X00001
1	0X0000000000000001
1	000000	00 0000 001
10000000 0X000	000X1
1X00000000000 N 0001
100XX00000000	00X  1
10 000  00X000 0X001
100000X00 0000000001
10000XX000000000 0X1
100000000000 	00	  1
1X00X0X 00000X	00 01
10000X0 0000 0	00	X1
100X000000	0000XX001
1000X0	0000X000000X1
11111111111111111111
