NO test_artifacts/valid.xpm
SO test_artifacts/valid.xpm
WE test_artifacts/valid.xpm
EA test_artifacts/valid.xpm
F 155,141,247
C 211,95,108

11111111111111111111
100X000 000000 000X1
1XX00000 000000000 1
1000000000 000	00001
100000	  0	0X	000	01
10 00XX000 00000 0 1
10000000000	000000 1
1 X00000000 0000 0 1
10000000000 00	00001
100000000		0000X0001
1000000000 0X0000001
1  0000000 00X0X00 1
1000 00X00X 0000 001
100	000000000X0 0001
10X0000X 0	000000 01
1000 000	00000000001
10	0 0000000000  001
1X000	0 	0 00  0 001
10	000N0X000X000  01
11111111111111111111
