NO test_artifacts/valid.xpm
SO test_artifacts/valid.xpm
WE test_artifacts/valid.xpm
EA test_artifacts/valid.xpm
F 27,21,111
C 87,166,11

11111111111111111111
10000110010110100001
10000000000101010001
10010000000110000001
10001010010000000011
11000000000000110001
10000101000000100001
10001100110100000101
10100010100001000011
10100100000000000001
10010000100000000001
10010010000001001001
10000000000000000001
10010100000001000001
10000010000000000101
10010000N00001001001
10010000000000000001
10000001000010000001
11000001010110000001
11111111111111111111
