NO test_artifacts/valid.xpm
SO test_artifacts/valid.xpm
WE test_artifacts/valid.xpm
EA test_artifacts/valid.xpm
F 62,126,110
C 119,89,236

11111111111111111111
11000000000010010001
10000000001010000011
10000000000010000001
11010110001010000101
10110111000000000001
10101100000001010001
10001000000000011001
11000011100000010001
10100001001101110001
10110110000000000011
10010000000000010001
11000100000011100011
10000100000000111001
10100000000000000001
10000000000010001001
1011000010N000001011
11000100000000000011
11000100010000010001
11111111111111111111
