NO test_artifacts/valid.xpm
SO test_artifacts/valid.xpm
WE test_artifacts/valid.xpm
EA test_artifacts/valid.xpm
F 209,0,0
C 53,163,148

11111111111111111111
1  000	00	X	00000X 1
10000X 0X0	00000XN01
100	0000X000X	000XX1
1 0 000000 000X00001
1000000X000XX00000 1
10 X	0	000X 0X0  X01
100000000X00 0X0 001
1 0 	0 X0	0 00000001
10	 0000 000X0X00X01
10 0000 0X0000000 01
1X000X000 0 X	0X	001
100000000X0  0000001
1000000 0X0000000 X1
100000X000000000 001
1000X 00 0000 0 0001
10 0000	X000	0000001
1 0000X0000	000X0 01
1	00000X0000	0 00001
11111111111111111111
