NO test_artifacts/valid.xpm
SO test_artifacts/valid.xpm
WE test_artifacts/valid.xpm
EA test_artifacts/valid.xpm
F 34,0,0
C 24,54,232

11111111111111111111
100X0X 000X 00000	01
10  0 000 0 000 0 01
1000000	0000 X0 0001
100000X000X000000001
100000	0	X00X0000001
1X000X00 0X  0000001
10000X000000000	00X1
10XX00000 0000X00001
10X00	0000X 00000001
100X000 	0000000X001
10 000	00 X0N0000X01
1  0X 0	000 00000  1
10000000	000 00 0001
10000 00 00X00000X01
10 	00	00	000	000001
1 X00000000	000000X1
10X 0000 00 0X000001
1000000	00	00	0 0001
11111111111111111111
