NO test_artifacts/valid.xpm
SO test_artifacts/valid.xpm
WE test_artifacts/valid.xpm
EA test_artifacts/valid.xpm
F 167,77,74
C 5,150,37

11111111111111111111
1000 00000 000000X01
100000000 0000X000 1
1X00X	00	0 000000001
10000000000	X0000	01
10000000X000 X000001
100000000X0000000001
10 0 0000X0000000001
10000 000  0 0000 01
100  000X0 000000 01
10 X0000X0	000000001
100	0000		 000	N0001
100	X000X0 X00000001
100	0	00 00000000001
10000X0000X00X000 01
1X00  000000 0000001
100000X	000000000001
100000000000000 0 01
10	00X 000	00X00 001
11111111111111111111
