NO test_artifacts/valid.xpm
SO test_artifacts/valid.xpm
WE test_artifacts/valid.xpm
EA test_artifacts/valid.xpm
F 38,84,212
C 227,32,38

11111111111111111111
10001000000011000001
10100000000010111001
10000000000000110001
1010N000110001000001
10000000100100000001
10010000111100010001
10000000000011000001
10000010010110110001
10000000000000010001
10001101000000010001
10000001100000000011
10001010001100011001
10000011010010100111
10000001000100000001
10001000010000000001
10000100000100010001
10010000001100000001
10100000000000000101
11111111111111111111
