NO test_artifacts/valid.xpm
SO test_artifacts/valid.xpm
WE test_artifacts/valid.xpm
EA test_artifacts/valid.xpm
F 8,,0,0
C 17,229,15

11111111111111111111
100000000 000X0	0001
100 00000 0	0 00X001
1000000000000 XX0001
1 000000000  0000	01
1000X000000X0X0000 1
10X00	00	0000X00 001
10000 0000	000000001
100X00X00000000	0 X1
1000000000000X 00001
10X 	000000 0000 X01
10X0 00 00	00000X0X1
100X00X000	00 00 0	1
1000	0 00N0000000001
1000		000000X 0 0001
10X0000000000 000001
1000  000 0XX	000001
1000 0	0X0	 0X000001
10	0 	000000 0	00001
11111111111111111111
