NO test_artifacts/valid.xpm
SO test_artifacts/valid.xpm
WE test_artifacts/valid.xpm
EA test_artifacts/valid.xpm
F 135,169,6
C 235,33,168

11111111111111111111
10100001000000010001
11000000100101100011
100N0100000000110001
10000000001001001001
10000000100001110001
10000000110000000101
10000010110010101001
10000101001100000001
10000011000001110001
10000001100100000101
10010000000100001001
11000000011100001001
11000010101001101001
10000101001000001001
11000000000000000001
10000000111000000001
11100011001100000001
10000101000010000001
11111111111111111111
