NO test_artifacts/valid.xpm
SO test_artifacts/valid.xpm
WE test_artifacts/valid.xpm
EA test_artifacts/valid.xpm
F 246,1,126
C 9,47,135

11111111111111111111
10010010001001100001
11000100010000000001
10100000000100010011
11110001010000000001
10000000001011110001
10111000001000000101
10000100000000100001
10001100110000000N01
10001000000010110001
11101100110110101001
11000000001001000001
10000000000000010011
10100000100000001001
10100001000000001001
10010010110010000001
11000001000000010101
11000000010100100101
10000001011000000011
11111111111111111111
