NO test_artifacts/valid.xpm
SO test_artifacts/valid.xpm
WE test_artifacts/valid.xpm
EA test_artifacts/valid.xpm
F 179,95,227
C 119,113,8

11111111111111111111
10000000010000100111
10001000000100011001
11110010001000100011
11001000000110010101
11010110000000100111
10000100001100000001
10000000000100100001
10010000000010010001
10001000001000000001
10000000000001000001
10000000000000000011
10000010000000000001
10000011010000000011
10001000000000010101
10000100000000000001
10100001000100001001
1000000000010N000001
10000010000000000001
11111111111111111111
