NO test_artifacts/valid.xpm
SO test_artifacts/valid.xpm
WE test_artifacts/valid.xpm
EA test_artifacts/valid.xpm
F 288,0,0
C 181,108,26

11111111111111111111
10 	 0	00X0	X	0 0 01
1X0 0	00X0000 000	01
1XX 0N00X0 00X	00001
1000X0000	00000000X1
1 000 0X0	000000X001
100X0000000X00X00001
1000 0000000	000	X01
1000X00000000	0X0001
1X0000 0 00X0 0000	1
1X000XX00000 0X00001
100	X00000 00000	0X1
10X0X 00	0X0 0000	 1
10		 0000X0 000 0 X1
10 X000000 0X0X000 1
1 00000 000 X00	0X01
10X0 00X000000X0X001
10X  00000000000	001
1000	000	00 0000 001
11111111111111111111
