NO test_artifacts/valid.xpm
SO test_artifacts/valid.xpm
WE test_artifacts/valid.xpm
EA test_artifacts/valid.xpm
F 226,0,0
C 40,15,156

11111111111111111111
100	00X00 000 X000N1
10 0 0 000 00 0X0001
10	000	 000XX00X0001
10000 	00	0000X00001
10 0	 00000000000001
10000000000000000001
1000X0000000X 000001
10000000X000 000	001
100  000000 00XXX001
100000000 000 0X0  1
10000000000000X0	001
100000 X00X0 000	001
10000000X00  00X0X01
10 0000 	00X00000	01
100X 00000000 00X001
1X000	XXX00X0 00X001
10 X0000X0000X00 	01
100000000000 0000001
11111111111111111111
