NO test_artifacts/valid.xpm
SO test_artifacts/valid.xpm
WE test_artifacts/valid.xpm
EA test_artifacts/valid.xpm
F 205,25,18
C 1,216,186

11111111111111111111
1000000X000 00000001
10 X000000		00	X00 1
10000000000000000 01
10 000	00000X0 00X01
100	0	X000 X00000001
10X0000000000	000001
1 00  X000	X000 00 1
10X000X0000000000001
1000000000X000000001
1  00000 X0 00	00001
10X0000 0000X000	001
10000000 0 0000 0 01
100000 0 0000X0X0001
100000000	00	0 0 001
100XX00	0 0000 0	001
10X00000 000 0X00001
10 0X0X0  0000 	 X01
1X00N 0XX00000X00001
11111111111111111111
