NO test_artifacts/valid.xpm
SO test_artifacts/valid.xpm
WE test_artifacts/valid.xpm
EA test_artifacts/valid.xpm
F 221,,0,0
C 177,198,13

11111111111111111111
10000	00	000 0 00001
1XX000000000000 0X 1
1000000 000000N00001
100 000 00000XX0 001
1 00000X000X0 000X01
10000X 00X000 0	0001
10X00X000 X0 00 0001
100 X000X00XX0000001
100 000 0000X000XXX1
10  0000	00000000001
100000	000X0X0000001
100X0000000000000001
1 0	X0  000000 000 1
100000	00000X000 X 1
1000000000	X000 0001
10 000000X000X000X01
1000 00X000 00000001
1X0000000000000000X1
11111111111111111111
