NO test_artifacts/valid.xpm
SO test_artifacts/valid.xpm
WE test_artifacts/valid.xpm
EA test_artifacts/valid.xpm
F 119,217,65
C 133,110,179

11111111111111111111
10 0000X 000000	00	1
10 0 0  000X0X0	 001
100X00 00 0X000 00X1
10000000000000000	01
10000X000000000X00 1
1	00 0000000X000X0 1
1 000000000 0000 	01
10 00 0X0000X00 X001
1000000	0XX0  000001
100 0X0 X0XX0X0 0001
10000000 	0	00000001
1 0000  00X00000 001
100000	 X00000X00 01
100 00000 00000	0XX1
1000X0 0000 00000001
100 00000X0 00000001
1	X	X0N000 000000X01
100000000	000X000001
11111111111111111111
