NO test_artifacts/valid.xpm
SO test_artifacts/valid.xpm
WE test_artifacts/valid.xpm
EA test_artifacts/valid.xpm
F 272,0,0
C 126,112,126

11111111111111111111
10000000000000		0001
100XXX00 000000000X1
1000X	000 0000 0X001
10 000000X0XX0000X01
1XX00X0000 0		000001
10000X0000 0000X0001
100000 0X0 0000000 1
100000000XX 00000	01
1000000 0N000X000X01
1000 0X000 000000001
10	00000  00 0000 01
10000	000000 00X	001
100   0	0000X0000001
10X00X0	00000 X0XX01
100 000000 00X000001
1X0 X0000X00	0 00	01
1 000X	00 0000000 01
10000000000000000001
11111111111111111111
