NO test_artifacts/valid.xpm
SO test_artifacts/valid.xpm
WE test_artifacts/valid.xpm
EA test_artifacts/valid.xpm
F 35,77,204
C 140,17,98

11111111111111111111
1	00000 00000000  01
100 00X 	000 00 0001
10 000  X00000000001
1000000 000	000000 1
1000000X0000	00	X0X1
100000000X0000X	0001
100000X	000X0 0X 0	1
1X00 00 000000000001
10000 000000X0000001
1	00X00 000 0 X0 001
10000000000000X00001
10000000X000	X	 0001
100000000 00000X0001
1000	00X000 00000001
10000000X	000X00X001
100000 0N00 00000001
100000X0	000X0	 00X1
10X0X00000  000 0001
11111111111111111111
