NO test_artifacts/valid.xpm
SO test_artifacts/valid.xpm
WE test_artifacts/valid.xpm
EA test_artifacts/valid.xpm
F 126,58,182
C 33,197,70

11111111111111111111
10 X0X0 0000000000 1
10000000	0 X000X 001
10000X0 000XX0X0X001
1	00 000000X00XX0001
10 00X0000	 0 0X0001
100 000X0	00000 0001
1000000X0000000XX001
10X00	00X 0X000	0001
10 0000X0 	00000 001
10X  00X00 X	0X00001
10 0N000000X0X0000	1
10 000 0000X000000 1
10 0 0	X0X000000  01
10000	 0X0X000000 01
1 0000	00	000X 00001
10	0XX 0  0X00 0X0 1
10 00 0 0X0		0000001
100X0	00000	0	0XX001
11111111111111111111
