NO test_artifacts/valid.xpm
SO test_artifacts/valid.xpm
WE test_artifacts/valid.xpm
EA test_artifacts/valid.xpm
F 244,128,241
C 163,217,196

11111111111111111111
10000000	00000000X01
1	00  0X 	00XX0 00 1
10 00  00000	0000001
10000XX000X0000000 1
1000000000000 000X01
1	000	0	0000000000X1
1000 000000000000 01
10000 000000000 0001
1X000000X0000 00 001
100X 	X 		X0000X0001
10X 0000X000000 0001
100 00 00	0	X	0	0001
100X000X00 0	0000	 1
10 0 00	 00 	0000001
10	0X0N0000000 00	01
100000 0000000000X01
10 X   000000	000001
100X0000	00000000001
11111111111111111111
