NO test_artifacts/valid.xpm
SO test_artifacts/valid.xpm
WE test_artifacts/valid.xpm
EA test_artifacts/valid.xpm
F 64,243,71
C 46,79,169

11111111111111111111
10000000000000000101
10000000011010100001
10001000001000010001
10000000000000100001
10001000000100010011
10000000010000100001
10000N00100011100011
10000000000010000001
10000000000010000001
10101000000000110011
11110000100000001001
10110010000011000101
10000001011000000001
10000001100100010101
10001000001100000001
10000110010111010001
11000000000100000011
10010000111001100001
11111111111111111111
