NO test_artifacts/valid.xpm
SO test_artifacts/valid.xpm
WE test_artifacts/valid.xpm
EA test_artifacts/valid.xpm
F 32,,0,0
C 144,227,247

11111111111111111111
100000000	00000 0001
1 0000000000X00000 1
1 0X0X00  X 00000 01
1000X000000000000X 1
100 000	X00000000 01
100 0000000000000001
10 00	 00X0X0 XX0001
1000000000000X0 0001
1000 00 0X 0000X0001
100X 0000000	00XX 01
10X0X0   0X000000001
10 0000000	00X000001
10000000000X000X0001
1000	0000000X000	0X1
1	  00	0	0000000 001
100X00000	000 000X01
1000 0 X	0	000000	01
1X0 0N000		00000 X01
11111111111111111111
