NO test_artifacts/valid.xpm
SO test_artifacts/valid.xpm
WE test_artifacts/valid.xpm
EA test_artifacts/valid.xpm
F 79,34,117
C 121,177,163

11111111111111111111
1000X	00	000 	0 0 01
1 0000	 0	00 0000001
1X00000000000000 001
1000XX00000000000X01
1000 0 00000000000 1
10000X0000X000 X00	1
10X00N000000 00X	001
100 0	X00X0	00000001
1000 00000	0	0X00001
1000X000X0XX00000X01
100000000X0000000001
1000 00X000000X00001
1 X  0		000X0 0000 1
10 00000X0 000000001
1X0000000000 0000001
100	X0000 000X00X001
10000 000 00X0000001
10000000000000 00001
11111111111111111111
