NO test_artifacts/valid.xpm
SO test_artifacts/valid.xpm
WE test_artifacts/valid.xpm
EA test_artifacts/valid.xpm
F 244,59,182
C 89,83,194

11111111111111111111
10000XX000	0X000X0X1
1000X0000X000 000X01
1X0000	0	00  0000001
100	XX000		000000001
1000X0 00X00 0000001
100000000X0000000001
1000 000000000N000X1
10000000 000000X0001
10000000000X000  001
1	000000	 0000000001
100000	 000000 000 1
100000000 00	0000001
1 000000XXXX0000XX 1
10000000000	00000001
100 0000000000 00001
1 X0000 00X00000X001
100000000000000 0001
1 X0X00000X0  00 0X1
11111111111111111111
