NO test_artifacts/valid.xpm
SO test_artifacts/valid.xpm
WE test_artifacts/valid.xpm
EA test_artifacts/valid.xpm
F 9,76,176
C 87,65,255

11111111111111111111
10100001000011000011
11001000010000001101
10000000110000000001
10000000000000000001
10000010000010000001
10000001001000000101
10000000000000001101
10000000001100010101
10101000000000001101
10000010100000010011
11010100100000010101
1011001000000N000101
10010000010000010001
11000001000000000001
10001000000000101001
11000001100010010001
10100001000010001001
11000010000110000101
11111111111111111111
