NO test_artifacts/valid.xpm
SO test_artifacts/valid.xpm
WE test_artifacts/valid.xpm
EA test_artifacts/valid.xpm
F 231,225,81
C 204,252,16

11111111111111111111
10000011000101100011
10000000000000000001
10011000100000000111
10110001000110000001
10100000000000110001
11001100000100001011
10000000011000000001
10001110100001000011
11010000010001010001
10110010110111000001
11000101000001010001
101100000N0000000001
11001100000001001001
10011010000110001101
10000001000000000101
10010000010100100001
10100000000010011101
10001000001000000001
11111111111111111111
