NO test_artifacts/valid.xpm
SO test_artifacts/valid.xpm
WE test_artifacts/valid.xpm
EA test_artifacts/valid.xpm
F 92,143,119
C 128,171,194

11111111111111111111
100X0 000	0X 	0	0001
10000000	X 0 0 X0001
100	00000X000   0001
100000X0  0000X00001
1	 00X0X0000X000XX01
10X000 00000X0N0 X01
10X000000XX00X0000 1
1 00X0000000000	00X1
1000000000 00000X0 1
100000000000000000X1
100X000000000	00 001
10 0X000X	 000000001
100	0000	00 00X00001
1X00000	0000X	000001
1000000000 0000X	001
1X000X 00000 0000001
1000 00	0 0000X 0001
1000 00000000000	 01
11111111111111111111
