NO test_artifacts/valid.xpm
SO test_artifacts/valid.xpm
WE test_artifacts/valid.xpm
EA test_artifacts/valid.xpm
F 192,135,231
C 217,248,77

11111111111111111111
100 00 0000N00  X001
1	00000X0X000000X001
1 0X0000 0000 X00001
1000000 	XX00 000001
10000	00000X0	000001
100	000000 X00 00X01
1 0000	000000 00 001
1000000X0000X0000X01
1X000 0 X 000000 001
10000X0	00X0000000 1
100 00	X0000  000001
10000 0X00X	00000001
10 0000000 00	000	01
100	 000000	0	00	001
1000	00X00000	00X0 1
100000000 0 000 00 1
1000000 00X0000  001
100000000 0000 X00X1
11111111111111111111
