NO test_artifacts/valid.xpm
SO test_artifacts/valid.xpm
WE test_artifacts/valid.xpm
EA test_artifacts/valid.xpm
F 80,190,140
C 140,53,55

11111111111111111111
10  00 0 00000X00001
1  	000000X0X00 0001
100X0000000000 00001
10000X0000000000X001
10 X000 00	0X0000001
10000000	000X	0 00	1
1X000 X00 	000 00001
1XX0X00000 000XX 001
100X0XX00000000	0	01
10X00X0	0 000X000001
1000 00 0	00	X00 001
10X 000000 000000001
100X000X00000XX	0001
10000 X	0000 0 00001
1000 X 	XX00 	000001
10X000 X00000 0	0	01
1  0	0X00N00X00 0001
1 00000000X	00000 01
11111111111111111111
