NO test_artifacts/valid.xpm
SO test_artifacts/valid.xpm
WE test_artifacts/valid.xpm
EA test_artifacts/valid.xpm
F 77,206,28
C 127,201,153

11111111111111111111
1000	00X000000000XX1
100X00 0X00000000001
100000X0X00000000001
10	00X	  0X0000000	1
10000	000 000	0000 1
1	000X00X00 00000001
1 0X0000000	0	 0 001
100000000X00000X0X01
100X00 X000000  0 X1
10000 000X0	0 000001
1X000 0 X00000000001
100	0000	00X	00000X1
1	 X0000000000000	01
10X0X0 0000	000 0001
1	00000 0X0X00000001
1 0 0000  X0X00000	1
1000000 0XN000000XX1
100000000	0000000 01
11111111111111111111
