NO test_artifacts/valid.xpm
SO test_artifacts/valid.xpm
WE test_artifacts/valid.xpm
EA test_artifacts/valid.xpm
F 197,62,5
C 32,228,138

11111111111111111111
1000 000	 0000000001
1	0X00000X0 0 00 0X1
1X00	0000 0000000  1
1000X0 	000000 0 	 1
100	000000000X0	 001
10X0X00XX0000 0 0001
1 0 00000XN00X0XX001
10X00000 0 0000X 001
10000 0000000000XX01
10 00X000XX000X 0X01
10000 0000 X000 	001
1X0000 0X000 0000001
1 0000000X0 00000001
100000000000  000001
10000X00000	 	0X0001
100000000000000 0001
1X0000000 00X0000001
1 0X00	0000  00000X1
11111111111111111111
