NO test_artifacts/valid.xpm
SO test_artifacts/valid.xpm
WE test_artifacts/valid.xpm
EA test_artifacts/valid.xpm
F 5,250,209
C 223,204,195

11111111111111111111
10000X 0000 00000X01
10 X0000 000 0000 01
10 00000000000000001
1000000	 000000X0001
100000000000	0000 01
1000000000X00X000001
100	000X0000X0000	 1
100 0000 0 000000X 1
1000000000000	000001
100000	0 00000 000 1
1000X0000 0000000001
10 00000000000000001
10000 00000X00X00001
100000XX00XX0000 001
1X00X0 00 00000000X1
10	0X00	000 00X0 0 1
1 0000	00000000  001
1000XX0NX0X000000001
11111111111111111111
