NO test_artifacts/valid.xpm
SO test_artifacts/valid.xpm
WE test_artifacts/valid.xpm
EA test_artifacts/valid.xpm
F 254,30,12
C 4,204,105

11111111111111111111
10000000 	000	0000 1
10000000 00000 00 01
1000X000000000000001
100 000	0  0000 0X01
1	0000X000 0XX000001
10X00000 0000N000001
1 0000000000	0000001
1000000000X00000	001
1000 00000X0000 00X1
1000X00000000X000	01
1000	0 0000 0XX0X001
10000 00000X00000X 1
1X0000XX00 00X000001
1X000 X0000X0XX000	1
1 0 0	000 00000XX001
100X000	0 0 0X 00001
1X000 0000X00 0000X1
1X0000	0X	0000000001
11111111111111111111
