NO test_artifacts/valid.xpm
SO test_artifacts/valid.xpm
WE test_artifacts/valid.xpm
EA test_artifacts/valid.xpm
F 77,251,58
C 171,133,88

11111111111111111111
1 00000X	X0000000X01
10 000X 0000000 0001
100000X00000000XX001
100000X0	00 00000001
100000X000000X0XX0	1
1000000 0X	00000 001
1 000000	0	00000N 01
10000000 0000000X001
1X	00000000000 00001
100X0000000000 000X1
10XX00X00 0000X00 	1
1000 00X00X000	0XX01
100000000000 0000001
1	000 0X00000	0 0 	1
1	0 0X0  X000	000 01
1000000000X0X000 0 1
1000X00000 00	000001
1X000X0 00    	000X1
11111111111111111111
