NO test_artifacts/valid.xpm
SO test_artifacts/valid.xpm
WE test_artifacts/valid.xpm
EA test_artifacts/valid.xpm
F 142,112,246
C 17,85,82

11111111111111111111
100000000XX000000	 1
10X0X X000X0 X0  001
10000000000000000001
100X00X00 0 000000	1
100X  000000	X0  X01
10 0000 0 	X000000X1
100	00 0000000 X0001
1000000	000000000X01
10000000 00X00X0X 01
1	0 0 0000	 00N00001
1 0X00000000X00  001
1000		000000000 00X1
1 X0	00 X0 0	X000001
1 0X00000 XX00X 	0 1
10000 000X00000X0001
10 0000000000 0X0 01
1000X0X0000 X0000 01
1X00 	0000	 0000 0X1
11111111111111111111
