NO test_artifacts/valid.xpm
SO test_artifacts/valid.xpm
WE test_artifacts/valid.xpm
EA test_artifacts/valid.xpm
F 173,59,111
C 220,217,77

11111111111111111111
100X0 000000 X00 001
1X0XX	000000 X0 0001
10	 0X00X 0000	0	001
1000000X0000000X 001
10X000X0	X000 0X0001
1	0000X0000	0X0 0001
1	X000X0	0000 0X0 01
1X00000 X00X000000 1
10000	000 000000 0X1
1000000000	00X000 01
10 0000000X0000  0	1
1000XX0 0XN00 000001
100 X00  X0 00000001
1000000	0X000000 001
100000000 0000000001
10000 0X00 000X00001
1000X00  000000 X001
10000	0000XX0000 X01
11111111111111111111
