NO test_artifacts/valid.xpm
SO test_artifacts/valid.xpm
WE test_artifacts/valid.xpm
EA test_artifacts/valid.xpm
F 47,104,82
C 242,32,67

11111111111111111111
1000000000  00  0001
1 00X0 00X	0X0000 01
1 0000000000X0000001
10 0X0 000X0 X000 01
1X 0 000000 00000 01
1000 000N00000000001
1000000000 0000 0 01
1000 00	 000000000 1
1	00X0X0000000	00001
1X00000 000X00000X01
1 000 000X00X0000001
10000 0XX0000	000001
100000000 0X000 0001
1000000X000 0	0	0001
1000X 0000000 0000X1
1X00 0X00	0000000001
10000000000X000000X1
1X 0X000000  0 0 001
11111111111111111111
