NO test_artifacts/valid.xpm
SO test_artifacts/valid.xpm
WE test_artifacts/valid.xpm
EA test_artifacts/valid.xpm
F 3,88,92
C 79,171,169

11111111111111111111
100X0000000000000X01
1000 0000	0000000X01
1X0000X0000		0X00 01
10  0000X00000000X 1
1000  X00 0	000X0001
100000 0XX0X00X00 01
1 000000000000000 01
10	 000 00XX000 0001
100X0000 00000  0001
10 000	X0X0	00	00	01
10X000X0000000000	01
10000000000X00000N01
100 0X 0XX00 000  01
1000 000X00X00	 0001
1 00 0 0000000000001
1000000X0 0X00000001
10X000X0	X0 000 0001
10X000	000000000X001
11111111111111111111
