NO test_artifacts/valid.xpm
SO test_artifacts/valid.xpm
WE test_artifacts/valid.xpm
EA test_artifacts/valid.xpm
F 235,7,220
C 57,15,109

11111111111111111111
10000000100010010001
10100000101000000001
11000001000000101001
10000010000000100001
10001010000000001001
11000010000100000001
10001000001000100001
10011011000100000011
10011011000000001001
10010001000010001001
10001110000000001101
10110000100010000001
10000000111000000101
10000100000000000001
1101001100000N010101
10001000000100000001
10001001000010000001
10001000100100011001
11111111111111111111
