NO test_artifacts/valid.xpm
SO test_artifacts/valid.xpm
WE test_artifacts/valid.xpm
EA test_artifacts/valid.xpm
F 137,43,171
C 106,251,189

11111111111111111111
100000000X0 	0000001
10 0X0000X00	000	 01
10000X00000  0000001
1 X0000000X00X	 00X1
1	0000000 00000000X1
10 00 000 	0000000 1
1000X XX0 0	X0000001
100X0X00000000000001
10000000000X0X0X0001
10	0N000	000000 	001
1	00X00000 000	 0001
1 0000000000000	00X1
1 00000000XX0X0X00	1
1	0000 0000 X0	 0001
1	0000X0000X00	00	01
10 000000	0000000001
100 0	00000X000	0001
10000	00000000X0 001
11111111111111111111
