NO test_artifacts/valid.xpm
SO test_artifacts/valid.xpm
WE test_artifacts/valid.xpm
EA test_artifacts/valid.xpm
F 144,0,0
C 125,86,138

11111111111111111111
10000000X	0000X00	01
1X0  0000 0 X00	0001
10000XX0 000X0XX0001
100000X00000	 	0X001
100000000X00000	00	1
100X00000	000000 001
1 0000 0  00 000 0X1
1000X00 00	000XX 001
1 X000 0000000000001
1 0 00000NX0 0 00001
1 00000 X0 0000000 1
10X00X000000000 00 1
100XX00X0000X0000001
10000	 0X 0000 000 1
1 X00 000000X 00 0 1
1000000000000 000	01
100	0	00X000	00 0001
100X 00X0000 000 001
11111111111111111111
