NO test_artifacts/valid.xpm
SO test_artifacts/valid.xpm
WE test_artifacts/valid.xpm
EA test_artifacts/valid.xpm
F 143,65,193
C 114,201,6

11111111111111111111
10000	 0X  0 0000001
1  X00000000000000	1
100 00  0 0X00X00001
10	00000000 0000 001
1 0 0 00000000000001
1000X0000N00 000 001
1  00000000000 00001
10000000 000X0X00001
10 	00	00000	0		 001
10000X00000000000 01
10 00000000000000 01
10000000000 00000001
10 000X0XX0000000		1
100XX0	0 00000X 00 1
10X000000 0  	X000 1
100000 00	00	X000001
10000X0000X00 000001
1000X00 0 00000X0001
11111111111111111111
