NO test_artifacts/valid.xpm
SO test_artifacts/valid.xpm
WE test_artifacts/valid.xpm
EA test_artifacts/valid.xpm
F 89,78,195
C 137,125,158

11111111111111111111
1 0XX00 000 00 	0001
10X00000000000000001
100000X0000 00000001
1X00 0	00000000 	001
100	00000 0XX000X001
1X00X0X0	0X00X000001
10000X000  00	 00001
10000000000	000 X0 1
100 00000	00X0X00X 1
1 X00 00 00000000001
10X00000 	X0X 0X0001
100000 000	000 0 001
1	00000 0X 00 000  1
1X0	0000 00000000001
100000 0	0000		0X001
100NX00000 0XX000	01
10000	00	X 0	000X0 1
1 000000	00000000001
11111111111111111111
