NO test_artifacts/valid.xpm
SO test_artifacts/valid.xpm
WE test_artifacts/valid.xpm
EA test_artifacts/valid.xpm
F 236,99,168
C 178,17,248

11111111111111111111
10000000X000X00000 1
100000000 000000X001
10000 0X	0000000	0X1
1000000X00000X000001
1000000	0 	 000000 1
100X000X 00000000001
10 000	X000000 0X001
10000 00	XX0000000X1
1 00000 000 0000X	01
10X00	 0 000000 X001
1000000 0X00000000 1
100	000 0000 000X0 1
10000000000	00000X01
1X000000000X0000X001
1X 00000	0000X000001
1000000  X00 0000	01
10000N 000000 XXX001
1 0 00000000	0000001
11111111111111111111
