NO test_artifacts/valid.xpm
SO test_artifacts/valid.xpm
WE test_artifacts/valid.xpm
EA test_artifacts/valid.xpm
F 28,41,107
C 7,208,23

11111111111111111111
1X000 		000000 	0001
1	X000X	00000	000	01
1000000000000X	X0001
100 00XX000 00000001
100000000	0X00X	0001
1 00  0 0 0 0X 0 001
1000 000 000 0000001
100 00000000 X000X01
1000	000 00	 0000001
1X000 000000000	0 01
100000000000 00XXX 1
1000000	00000 00 001
1000000000000X0X0001
1000X0000X0000000001
10000000000X00000X01
10  0 0000000	000X01
10 0 00X000000000N01
1X0000000000000000	1
11111111111111111111
