NO test_artifacts/valid.xpm
SO test_artifacts/valid.xpm
WE test_artifacts/valid.xpm
EA test_artifacts/valid.xpm
F 169,126,251
C 81,81,155

11111111111111111111
10000000100010000001
11000010000010010001
11000010001100001101
10000000000100010001
10001000000100101001
11001000000000000001
10100001010100001001
10000010010000000101
11000010001000000001
10001001101001110001
10001010100000001001
11011000000000N00101
10000000100000000011
10100000000100000001
10001000001000010011
10000000000110010011
10000001000000000001
10000100100111100011
11111111111111111111
