NO test_artifacts/valid.xpm
SO test_artifacts/valid.xpm
WE test_artifacts/valid.xpm
EA test_artifacts/valid.xpm
F 8,240,234
C 7,8,214

11111111111111111111
100000	00000000 0001
10	000X00X0000000X 1
10000000  00X 00X0X1
1000000X00  000 0X01
1000X00XX000000X0001
10 000	X000000000X01
10 000000 0000000	X1
100 00000	 00N000001
10	000X0000X0X 00X01
10 00000	 	000000 01
100X0000000  	 0 001
100000000	0X 00X 001
1000  0X 000	0X00001
10XXX 000X000XX000 1
10000000000000 0	001
1000XX00 00X0 000001
1	00 0000	0	0 000001
10000 00000000X 0X01
11111111111111111111
