NO test_artifacts/valid.xpm
SO test_artifacts/valid.xpm
WE test_artifacts/valid.xpm
EA test_artifacts/valid.xpm
F 21,144,62
C 250,255,145

11111111111111111111
10000000001100010001
10000000000100011001
10110000000000110001
100000N0010000000001
10000000000000000001
10000000101100000011
10000000101000000001
11110010110000000001
10000000000001010011
10001001000010011001
10000000000000000001
10000010000000000111
10000000100001100001
11000000000000100001
10000000000101010001
10100101000000000101
10011000100000000101
10000000001000110001
11111111111111111111
