NO test_artifacts/valid.xpm
SO test_artifacts/valid.xpm
WE test_artifacts/valid.xpm
EA test_artifacts/valid.xpm
F 60,184,65
C 239,158,12

11111111111111111111
11000100110000101001
10010000000000000111
10000001001001000001
1100000000000000N001
10000000010001000011
11100000001101000101
10001000100000000011
10000001011000000011
10000000000001000101
11000000100000000101
10000000000001001101
10100000100000000001
10000000010001110001
11000100000010001101
10000000000001000001
10010010000000000001
10000111000000010001
10100000001000000001
11111111111111111111
