NO test_artifacts/valid.xpm
SO test_artifacts/valid.xpm
WE test_artifacts/valid.xpm
EA test_artifacts/valid.xpm
F 211,208,65
C 224,205,243

11111111111111111111
1  000	X000000000X01
1000X00000N0000 0001
1000X0000000 0000001
1 00000 0000 X000001
1 X0X0X0000000000001
100000X	000000X00X01
1X000000000X00000	01
1	000 000X000 X00001
1   0000000X00000X01
1X0X00X00 00000	0X	1
100	00 X00000X0000 1
10	000X00000XX000001
1000 00X00X00 000001
1000 0XX0X0X0000 X01
1  0000XXX00X0000001
1000X00	0000X0	00001
100000000000 	000001
10  000000	0XXX00001
11111111111111111111
