NO test_artifacts/valid.xpm
SO test_artifacts/valid.xpm
WE test_artifacts/valid.xpm
EA test_artifacts/valid.xpm
F 73,103,81
C 224,113,201

11111111111111111111
10000000000001001001
10000001010000000001
10000000100001000001
10000000000000010101
11000101001100010001
10010010110000000001
10000111000001000011
10000000000010100011
10000110000001010001
11010010000000000001
10001001010000010001
10000000011100000011
11010000011000000001
11001001000000000011
10001001000000000001
11000000000010010111
1100N010100100101001
11000000000100000001
11111111111111111111
