NO test_artifacts/valid.xpm
SO test_artifacts/valid.xpm
WE test_artifacts/valid.xpm
EA test_artifacts/valid.xpm
F 5,,0,0
C 120,19,104

11111111111111111111
1000 00000X000N00001
100X00X00X0 X0000001
10000X000000000XX 01
1000000000000 0X0001
100	X0	00000XX0X0001
100000 00X 0  00 0	1
100	 00 000000000001
1 0000X0000000  0001
100	0000XX0000 X0001
10 0000X000000000001
10 00X0000000 00X001
1X X 000	 	 00000	01
10	0000000000	00X001
1000000	00000X000001
100000X00 0000 0	001
100X00X000	000000001
100000000X00 0000001
10X0000XX00000000  1
11111111111111111111
