NO test_artifacts/valid.xpm
SO test_artifacts/valid.xpm
WE test_artifacts/valid.xpm
EA test_artifacts/valid.xpm
F 271,0,0
C 233,59,48

11111111111111111111
100000 00000000	0 01
1X00 0X000 00000  01
1X00XX00	0 000 0 001
1	000000	00000000 01
10	0000X0000	0	X	0X1
10000 00X00 00000X01
1000X0000X0 X0000001
10 0000 000000000001
10000000000000000001
1X0000 00N00000X00	1
10000X000 0000		0001
1	00000 00000000 001
1	X000XX000000000001
1 0X0	XX0000 000X 01
1X0000000 000			0001
1 00	00 00 	00000 01
1	 X0000000	X0 X0001
10 X00000000X0000001
11111111111111111111
