NO test_artifacts/valid.xpm
SO test_artifacts/valid.xpm
WE test_artifacts/valid.xpm
EA test_artifacts/valid.xpm
F 152,158,202
C 96,94,213

11111111111111111111
10011000000010000001
10001000000000000001
10001010000000010101
10001011000000000001
101001000111000N0001
11000000000011000001
11000000000111010011
10100011110000000111
10011000111100001011
10100010100001000001
10000100000100000001
10000001000001000011
10100000000001000001
10000001011000100101
11000011000101101001
10000010000010000001
11000101000100000001
10001001000101000001
11111111111111111111
