NO test_artifacts/valid.xpm
SO test_artifacts/valid.xpm
WE test_artifacts/valid.xpm
EA test_artifacts/valid.xpm
F 60,64,190
C 151,203,39

11111111111111111111
10 000000000000 0X01
10X000 0 0000X000001
1XX000	000000000	001
10 000000	00	0X0X 01
1X 0000000 00 0000 1
1X000XXX00X 00000X01
10 000X00000X000X001
10	00000X00 0000X0 1
1	 00 0000000	000001
1X 000X0	000X00	0	01
1 0000X0	0000 000001
100000000	0 00 00001
1 0 000000000 000001
100 0000 0X0 0000001
100 00	0000 000X0 01
1000000X0	0X0000N001
1X000X X000 00000  1
10000X0000 00X000	01
11111111111111111111
