NO test_artifacts/valid.xpm
SO test_artifacts/valid.xpm
WE test_artifacts/valid.xpm
EA test_artifacts/valid.xpm
F 7,119,136
C 26,159,82

11111111111111111111
11100010000000000001
11010001001000101011
10000000000000000101
10001000101010101101
10000110000100000001
10000010010101000011
11010011000100001101
10000000000000001001
10000001000111000011
11001100000000010101
11000100000011100001
11010001001000000001
100000000000N0000001
10110100010000010011
10000000000100000001
10000101000011000001
11000001000100000001
10000000010000000001
11111111111111111111
