NO test_artifacts/valid.xpm
SO test_artifacts/valid.xpm
WE test_artifacts/valid.xpm
EA test_artifacts/valid.xpm
F 6,141,136
C 159,107,199

11111111111111111111
10001000000000001001
10101001000010000011
10000001000000110001
10000100000100000001
10000101100001000001
10000000000001000001
10001000000101010001
10000000000001010001
10000010000000000011
111001000N0001000101
10100101000001000101
10011000000110000011
10100000000000100001
10000000000100100101
10000101010000100001
10000001001001000001
10000001000010001101
10000000000001010001
11111111111111111111
