NO test_artifacts/valid.xpm
SO test_artifacts/valid.xpm
WE test_artifacts/valid.xpm
EA test_artifacts/valid.xpm
F 134,0,0
C 6,200,48

11111111111111111111
10 0 0000  00XX00 X1
100000000000X00	0 01
1 00000	000 0000 001
1000	000000000	0 001
100000 XX00000000001
100000000X0000	000X1
10000	00000 	00000 1
100000 00 0000 00001
10X00000000000  0  1
100000NX0 00 00	0001
1 	000	00000	X00 001
100000000000X 0X0001
100000 000  0	 00001
1000 X000000 00X00 1
1X0000X0 X	000 00 01
100 00 000 0 X000X01
1X 000 0X00 0  00X 1
100	0000000000 X00	1
11111111111111111111
