NO test_artifacts/valid.xpm
SO test_artifacts/valid.xpm
WE test_artifacts/valid.xpm
EA test_artifacts/valid.xpm
F 89,0,0
C 135,216,218

11111111111111111111
1 000X00	 0	0000X X1
100X0X00000000 0 001
100 00000  	000	 001
100 0X0000	0000 0001
100 0 000 00 00000	1
10	00	0X000000000001
1X 00X0X0X0	X0000001
100	00000000 X0X0001
10000X0000X000000001
1X0 00000 0000	00 01
100000000	0X0000	001
100000000 0X 00000N1
10000X0 000 0 0	 001
10 00X00 0000000 0X1
1000000	 	 000 0X001
1 0 000X000X00000001
100 0 0000 000000001
1000000X000000000001
11111111111111111111
