NO test_artifacts/valid.xpm
SO test_artifacts/valid.xpm
WE test_artifacts/valid.xpm
EA test_artifacts/valid.xpm
F 268,0,0
C 19,49,225

11111111111111111111
10000XX00000	000X001
1000	00 0	00X0000001
10000 0000	00  00001
100 00000X00	X0000 1
1000 0X0000	X0000001
1	00 X000000	0 X0001
10	0		0000000	0000X1
1 00 000000000 00 01
10000000X 00000X	001
1	0	00000000 0X0 001
100 00N00X0X 0 00001
10000X0X0X0 0000 001
10 00 X	000X00000001
1X000X0000000X0X0	X1
10000X00 00000000001
1 00000000000X00	0	1
100 000000000 000001
10000 0000 00000 0X1
11111111111111111111
