NO test_artifacts/valid.xpm
SO test_artifacts/valid.xpm
WE test_artifacts/valid.xpm
EA test_artifacts/valid.xpm
F 95,119,151
C 108,160,85

11111111111111111111
1 0000000000000000 1
100X00000 XX   00001
100X0	0XX00	000XX001
100000000000000X0001
10000X0X000000	000 1
1000	N00000  0X00001
100X	000000 000X0001
10000 	00 XX00 000 1
1000 0000X0 00000X01
10000 00000000X00 01
10 	000000000000 X01
10000	0	00000 000001
1000	000000000	  001
1 00000 00X00	00 001
100000 0000000000001
100	 	00000000000001
10000000000000000	01
1X0000 0000000000001
11111111111111111111
