NO test_artifacts/valid.xpm
SO test_artifacts/valid.xpm
WE test_artifacts/valid.xpm
EA test_artifacts/valid.xpm
F 66,132,212
C 30,178,46

11111111111111111111
10000X00X0X000000X01
100000X0X00 0XX 0001
10X00000000 0XXXX0 1
1X	0 000000000X00001
100 0000000X 00X00X1
1N0X000000000 00X001
10000	00 0	00 0X	001
10X00 0	X0000 X00X 1
1000000X00000000	0 1
1 X000  0000	 00	001
100X0X0 0X0 X000X001
10000 000 	00	 00001
100X0000  000 0 0X01
10	00	0000000X0000X1
1000000	00 000000001
1 00X0 000 000000001
1	0X	 		X 0000000001
10  00X0000000X0	X01
11111111111111111111
