NO test_artifacts/valid.xpm
SO test_artifacts/valid.xpm
WE test_artifacts/valid.xpm
EA test_artifacts/valid.xpm
F 172,0,0
C 206,205,242

11111111111111111111
100000X0X000 000 0 1
100000000 000X   001
10  00 00	0X0X000001
100000000	00 0	X0 01
1000 00	00000XX 0001
100 0000	00000	00001
1X000000X000X  00001
100	 X000 000X  0001
1000	0 00  0X00000	1
1X 00000000000000	01
100 00XN0 0000000001
10 000000000X00 0001
1X000	00000000 	0X 1
100 00X0 00000X00001
1000000000000 00 0 1
100000X000X000 00X01
1 0	0000X000000 0001
1 0X00 X0 000X00 001
11111111111111111111
