NO test_artifacts/valid.xpm
SO test_artifacts/valid.xpm
WE test_artifacts/valid.xpm
EA test_artifacts/valid.xpm
F 20,145,222
C 248,22,91

11111111111111111111
1X000X0	X000  00	 01
100000000 X000X00001
1000X0000 X00	000X01
10	 0X00000000000001
1N	00X 0000000000001
10000000000000 00	01
1000000X00000 X000 1
1X0X00000 0000000 01
1000 X0X0000000000	1
1000 000 0X 0000  01
1X0000 00 0 00 000 1
1000X  0	00X00000	01
1000000000000 000001
1X00X0000000X0 0	001
100000000000X0XX0001
1X0000X000	000 X00	1
10	0X00 000X00000001
100	0 00000000 	0001
11111111111111111111
