NO test_artifacts/valid.xpm
SO test_artifacts/valid.xpm
WE test_artifacts/valid.xpm
EA test_artifacts/valid.xpm
F 95,192,68
C 54,130,114

11111111111111111111
100 	00000	XX00 0001
100 00X00X00	 0000	1
10	0 0000X000X00X001
10 00X0000000XX00001
10000000000	000000X1
1X00000000X0000000X1
1000X0NX0000000 0001
10 00X000000 00X0001
1X 00X	0	0 0 0000	01
10000 000 0000000001
100	0000000000000001
1X0000 000000XX00  1
10 00000000000000001
1X00000X00 		0	0 001
100X00000 0000000001
10000X00 00000 0 001
1 0X000000   000	001
100000	00000X000X0X1
11111111111111111111
