NO test_artifacts/valid.xpm
SO test_artifacts/valid.xpm
WE test_artifacts/valid.xpm
EA test_artifacts/valid.xpm
F 83,,0,0
C 11,145,8

11111111111111111111
10000	0 000000000001
10000000X000 0000001
10 00X00 0X 0000 001
100X0000  0000000001
1000000 00X0X000 	01
100X0 00 X00	000X001
1 0000 000 000000001
100000  	00	000  001
10	0000 00000    	01
10000X0X0X 0	00000 1
1X00000X00000 000	01
100 X00 0000000 0001
100000		0	X0000000 1
10X00000 0X000000001
10 		X0000000X000001
1 000 X00 000000 001
100	00000000 0000NX1
1000000  000X0000001
11111111111111111111
