NO test_artifacts/valid.xpm
SO test_artifacts/valid.xpm
WE test_artifacts/valid.xpm
EA test_artifacts/valid.xpm
F 87,220,235
C 185,195,236

11111111111111111111
10000100000000000001
10000010100011010001
10000010100000010001
10100000010100001101
10011000011000000011
11010110000000000101
10000000000010000001
10000010000000100001
10100100000101000001
11010100001100000001
10000010000000000101
11001000000000000111
1000010N000010000111
11101000000000000001
10000000110000000001
10000010100000100011
10000001010000000001
10000100010100100101
11111111111111111111
