NO test_artifacts/valid.xpm
SO test_artifacts/valid.xpm
WE test_artifacts/valid.xpm
EA test_artifacts/valid.xpm
F 212,74,25
C 55,194,160

11111111111111111111
10000000000100100001
11100100010000100001
11000011000101110001
10000000100000000001
10000010000010000001
10000010010000101101
11110000000101000001
11010011100000100101
10001000000000000011
10001100001000000011
10100000000000000011
10110000000000100001
10001010N01000000001
11001000000100000101
10000000111001000011
10001000100101000011
11000000000000010001
11001010000010010011
11111111111111111111
