NO test_artifacts/valid.xpm
SO test_artifacts/valid.xpm
WE test_artifacts/valid.xpm
EA test_artifacts/valid.xpm
F 28,,0,0
C 154,199,66

11111111111111111111
1X000000N000000000 1
10X000 000 X 0  00 1
10X0 00 000000000X01
1000 0 00000X0000001
1 00000000 000000001
10000X0		00000000X01
100X 000X000 0 000X1
1000X00000 000000 01
10X0000000	000X00 01
10	0 00000000	0 0001
1XX0000000 0	0000001
10	0 000000000 00001
100000 	0X0	00000001
1	000000X00 0 000001
10000000 X0000000001
10X0000	00	 00000001
10 00 00000 	0000 X1
100000 0000000	000 1
11111111111111111111
