NO test_artifacts/valid.xpm
SO test_artifacts/valid.xpm
WE test_artifacts/valid.xpm
EA test_artifacts/valid.xpm
F 223,122,151
C 187,50,103

11111111111111111111
11010000001000000001
10000010010001000111
10001000000100010001
10001001110100000001
10000000000100000101
10000000000000100001
10100000010010001001
11000010100000000111
11100110000000000101
10000011000010010001
100000000N0000011011
10010000000100000001
10000010100010000101
10100111000100001001
10000000000000100001
10000000011110000011
10000001000001000101
10000010000001000001
11111111111111111111
