NO test_artifacts/valid.xpm
SO test_artifacts/valid.xpm
WE test_artifacts/valid.xpm
EA test_artifacts/valid.xpm
F 38,224,99
C 86,115,14

11111111111111111111
10100011001000000001
10000001010000000001
11000101011100000101
10100000000100000001
10100000001010000101
10000100001001001001
10000101000000100011
10000100000000010011
10000000000000010001
1000N000000000000001
10000000000001000001
11010100000000000001
10010000000000010001
10001000000001001011
10100000000000000001
10010000011000001001
11001001100000100001
10000000000010000001
11111111111111111111
