NO test_artifacts/valid.xpm
SO test_artifacts/valid.xpm
WE test_artifacts/valid.xpm
EA test_artifacts/valid.xpm
F 93,89,224
C 70,250,101

11111111111111111111
10001000100000010001
11100011000001000001
10000001000100000N01
10001100010110000001
10110100011000000001
10001110000100101001
10000110000001000001
10001000001001000001
10010001010000010001
11100001000000100011
10000001010000000001
10000001000100011011
10110000100000000101
11000000000010000001
10010100000000011111
10000100000000000001
10000000101000000001
10000000010110000001
11111111111111111111
