NO test_artifacts/valid.xpm
SO test_artifacts/valid.xpm
WE test_artifacts/valid.xpm
EA test_artifacts/valid.xpm
F 223,0,0
C 115,91,193

11111111111111111111
1 00X00000000X0X0001
10000	0X0000000X0001
10X0 X00X000000 00X1
10000000	000000	0001
10X00 00	X 	00	00001
1000X 000000 0000X 1
1000 	00000000  	001
1X000X000	0000	 0001
1000X 00  0	 00000X1
100 000000000X 00001
100 000X0000 00000 1
100 	00000 00	00 001
100X0X0000000	N0 0 1
100000000X000 000	01
1X00000X00	000 000X1
1000 000X00000000001
1000X0000XX 	00X	001
1X 0000	X0X0	0000 01
11111111111111111111
