NO test_artifacts/valid.xpm
SO test_artifacts/valid.xpm
WE test_artifacts/valid.xpm
EA test_artifacts/valid.xpm
F 133,,0,0
C 49,56,174

11111111111111111111
100000 00 0000000001
1  0X0000 00 0000001
100 000000	X0X0X0001
1	0 0	0XX0000XX00	01
100000X00 00 00000X1
10	0000XX00000000001
1000X0000X000000	001
1 XXX0	X00X0	00X00	1
100X0	0000 	00 000 1
1000000000X0000 00 1
10000000000000	00001
10 00000	 00000 0001
1000000X00000 0 	0	1
100XX000000 X0000001
1000000	 0000 XX  X1
10000000X0 X00X000X1
100X0000N0X00X000001
1000000000000000	001
11111111111111111111
