NO test_artifacts/valid.xpm
SO test_artifacts/valid.xpm
WE test_artifacts/valid.xpm
EA test_artifacts/valid.xpm
F 149,171,180
C 40,40,249

11111111111111111111
11000001000000000011
10001001010010001111
10100100000010010001
10000001100000010001
10000100000000000101
11010000100000000001
10000001100100000101
11000000000100100001
10000100000011100001
10001000N00000010011
10000000000100000001
10100000001000001001
10000000011111000111
10000001000001100101
11000010000010110011
10001100001010101001
11000000001010000101
10100000010000000001
11111111111111111111
