NO test_artifacts/valid.xpm
SO test_artifacts/valid.xpm
WE test_artifacts/valid.xpm
EA test_artifacts/valid.xpm
F 25,212,162
C 27,39,38

11111111111111111111
100X0 0X	00000000X01
100000X 00000 0000 1
10000X000 0000X0 001
1X000000	X0000000001
1000000XX0	00	00	001
1000X 0000000 X00	01
1	0XX000000000000001
1000X0X000	X000X0001
100 	000X 0X 00X 001
100	000000000X 000 1
1000000000X0	000X001
100000X0 000X000 X 1
1X000    X000	0000N1
10 000000000000000X1
10X  	X0X0X000000001
10	00	00000 000X0001
1000X000000	000 0001
100000 0X0	000000001
11111111111111111111
