NO test_artifacts/valid.xpm
SO test_artifacts/valid.xpm
WE test_artifacts/valid.xpm
EA test_artifacts/valid.xpm
F 34,88,110
C 175,48,39

11111111111111111111
10000000000000X00001
1000 0 0 0	 0X  	XX1
10000000000000000001
100000000 0 000	  01
100000 000 000000001
1X0000X0 X0000	000X1
10X0 00 00X0X0000001
100000 00000X0000001
1000X0X0X0X0000 	001
1X00000	000  00 00	1
100 0000XX	00X000X01
1 0X0X00000X000N0001
1000 X0X000X000X00 1
1000X00X0   000000	1
1000X0000000000X	001
1 00 00 0 000X 0 001
1000  0X0000000X0	01
1 000X000000 0000 01
11111111111111111111
