NO test_artifacts/valid.xpm
SO test_artifacts/valid.xpm
WE test_artifacts/valid.xpm
EA test_artifacts/valid.xpm
F 43,100,206
C 43,190,82

11111111111111111111
10000000000101001001
10000000000100001011
10001001000010110001
11000000000000100001
1000110110N000000011
11000011000001100001
10011001000001000011
10000000100011010001
10100000000000000001
11100101000010100001
10100000000010000001
10010000000000011001
10100010000100101001
10010000010000010001
10000000000000100001
11010011100000000101
10011000000010001001
10000100010010100001
11111111111111111111
