NO test_artifacts/valid.xpm
SO test_artifacts/valid.xpm
WE test_artifacts/valid.xpm
EA test_artifacts/valid.xpm
F 129,217,207
C 3,6,135

11111111111111111111
1000000000 N0	00	001
1000X000000000000001
10000000 000	00 0001
100	00X00 00 0000001
10X0000000	0000X X01
1000000000X00XX00XX1
1 0000000		0  00XX 1
1000000000000000	001
10XX 0000 00000X0	01
100	00000000	00000 1
100  0X00000 00X0001
1 00000000	X00	X0001
1X 0X00000 0000000 1
100 X	0000 0000	0 01
1  	0	000 X	00X00001
1 00	X0 00000000X001
100000000000  00X		1
100X0 00X0X000000  1
11111111111111111111
