NO test_artifacts/valid.xpm
SO test_artifacts/valid.xpm
WE test_artifacts/valid.xpm
EA test_artifacts/valid.xpm
F 180,48,133
C 155,47,94

11111111111111111111
100000X00 00000000	1
1000 0 	0000000X0001
1000000000000000	 01
1 0000000X	0	 000	X1
10000000000000000001
10X0000X00	0000	0001
10000 0X 00000000001
1000000000X0000X00	1
1X0X00X 	00000	00001
10000	X0	000X00 0001
10 00000 00X000XX001
1 000 0X000X00000X 1
10000000	0000	0NX001
10 000000000000	0001
1X 000000X00 0000001
1000 000000000X00X01
10000000000X000000	1
1000000000 X00		0001
11111111111111111111
