NO test_artifacts/valid.xpm
SO test_artifacts/valid.xpm
WE test_artifacts/valid.xpm
EA test_artifacts/valid.xpm
F 228,162,128
C 105,147,19

11111111111111111111
10010010010000101101
10101100000000000001
11000100100001000001
11000000100011010001
10110010000001111001
10000000000100000011
10001000100000000001
10000000000000000001
10000010100000010001
10000000000001010001
100100N0000000000001
10000000010100100001
11101000000000000001
10010000000010001001
10000000000100000001
11001000000100010001
10001001000000000001
10000101101000010001
11111111111111111111
