NO test_artifacts/valid.xpm
SO test_artifacts/valid.xpm
WE test_artifacts/valid.xpm
EA test_artifacts/valid.xpm
F 79,206,199
C 165,211,230

11111111111111111111
1X000X 0000000 0 001
1000000000 00 X0	001
10000000X00000 0  01
100000 	000000000 X1
10000	00000000000001
1000 000000000000001
100XX0X 00000 0X00	1
100000N 000000 00	01
1000X000X0000X0000	1
100000 0 X0000X00001
1X0000X0000 0X00 001
100000000000X00000X1
10X00 0X00000 00X001
1X00000 0X0 00 00001
10X000000XX0X000 001
100 	00000	0X000 001
100X0X0X0000X0000X01
10 0000000 000000X01
11111111111111111111
