NO test_artifacts/valid.xpm
SO test_artifacts/valid.xpm
WE test_artifacts/valid.xpm
EA test_artifacts/valid.xpm
F 166,0,0
C 247,220,132

11111111111111111111
10XX0X X00 0XX0000X1
10000X0	00 000000001
100 00X0 00000X000 1
10 0 0000X	0000 X0 1
100 0000000 0000X001
10X00000  X0 0N00001
10 000000	000000	X01
1000 000X0X00X000 01
100000000XX0 	0	0X01
1000 000X00000000001
1 00 0000000X	0000X1
100000000XX00000	001
100X0	0X	0000 0 0001
10X0000  0000000	001
1X0000000000   00001
1000X000000000000 01
10   0	000X000000001
100000 000000 000001
11111111111111111111
