NO test_artifacts/valid.xpm
SO test_artifacts/valid.xpm
WE test_artifacts/valid.xpm
EA test_artifacts/valid.xpm
F 239,84,195
C 185,2,170

11111111111111111111
1	X000X00 0000 0 X01
1	0XX00X 0 0000 0001
10000000000000000001
10 0000X00000X000001
10	00000	00X00X	X0 1
1X 0000X0 	0X00000N1
10	0 	0X  000000 001
10000000000X00000001
100X0000X00000000001
10000000000000000X01
1 0 000000 000000001
100000X 0000000X0001
10 00	0 00000 000001
1000 000X0000	X00001
10 0000	XX0000 000X1
10	 00XX	00000000001
1 00X00  000 X00X0X1
100 X0X00X0000000X01
11111111111111111111
