NO test_artifacts/valid.xpm
SO test_artifacts/valid.xpm
WE test_artifacts/valid.xpm
EA test_artifacts/valid.xpm
F 154,,0,0
C 164,63,8

11111111111111111111
10000X000X0000000001
100	000 000  00X0001
1 00 X00	00000000001
10X0000 0 000 000001
10000000 0000000X001
100000 0000  00 0001
100000000 X0X0  00 1
100X000 0	00000	0001
10	00	X0		0X000 0001
100000X X00 00000001
100	00 X00000000XX01
10000000000000 00001
1 00000000000 00X001
1 0000X000X0000000X1
100X000 000X00X00001
1X000000X 0X00000001
1	0	0X000NX	0 X00001
1XX 0000	 000 X00001
11111111111111111111
