NO test_artifacts/valid.xpm
SO test_artifacts/valid.xpm
WE test_artifacts/valid.xpm
EA test_artifacts/valid.xpm
F 77,114,201
C 252,126,202

11111111111111111111
10001000000100000001
1100001010110100N001
10000110100000100001
10010000011000101001
10000100010000000001
10000100010000111001
10000001010010000001
10000000010000011101
10001000000000001111
10000100110100100001
10000000000000000101
11000100000001101101
10000000001010001001
11100001000010000011
10000000000010010001
10111000000000000011
10000000101001100001
10000110000000001001
11111111111111111111
