NO test_artifacts/valid.xpm
SO test_artifacts/valid.xpm
WE test_artifacts/valid.xpm
EA test_artifacts/valid.xpm
F 54,213,50
C 197,66,100

11111111111111111111
10001000001001001001
10010000000101001001
10001000010010000001
10000000000000000001
10000111000100100101
10N00000101000101001
10000001101010000011
11000000000100100011
10110000000000100001
10000001011010000001
10000001011000000001
10010000010000000001
10001001101001100001
10000100000000000001
10000010000000000001
10101000100011000011
10010000000000110011
10000010000001000001
11111111111111111111
