NO test_artifacts/valid.xpm
SO test_artifacts/valid.xpm
WE test_artifacts/valid.xpm
EA test_artifacts/valid.xpm
F 19,173,108
C 110,253,247

11111111111111111111
10X000 00 X000	0  	1
1XNX00000 000 000001
10000 0	0	 0000X0001
10000000XXX000000001
1 00 00000000X0X0 01
1X0 0	X 000X0 000001
100X0X0000X000000001
10 0000000 00 000001
1000  00000000X 0	01
1000000000000X000001
1	000000	0 0 000 0X1
1 000	00000X00	0  01
1000X	X00000  000001
100X00 0000000 0X001
100X00000XX0 00	 001
1 00000 0000000  001
100000000000X0000001
1000 000000X0000	001
11111111111111111111
