NO test_artifacts/valid.xpm
SO test_artifacts/valid.xpm
WE test_artifacts/valid.xpm
EA test_artifacts/valid.xpm
F 0,0,0
C 151,122,104

11111111111111111111
1	XX00 000X  0 	0  1
1000000000 000X00001
10000000X00000000X	1
100 00000000000 0	01
1X000X000000X00 0001
1X000	X0000X00000 01
10000	00  0 000X0001
100000 X 00000X000 1
1	0 000000	00	 0X0X1
1000X000X	 000000001
10X000000000	X0X	001
10	XX0 00	X000	00001
100000 0 00000000001
100	0000000000 00001
10XX00000000 0	 X001
1XN000 0	00000000001
1000000 000000X00001
1000000000X00	00X001
11111111111111111111
