NO test_artifacts/valid.xpm
SO test_artifacts/valid.xpm
WE test_artifacts/valid.xpm
EA test_artifacts/valid.xpm
F 225,0,0
C 143,197,12

11111111111111111111
1 000X0XX000000  X01
10 00000000000X00001
10X00000000	 00 0001
1 000	000 0 00X0X	01
10000X0 000 00X 0001
1000X	000000 	000001
100X00000	0	00 000X1
1X000000 000X00 00 1
100000000000	0X000X1
1 X	0 00000000000 01
100 0000X0 	 00X0001
100	X00X00 0	 0000 1
1X0000000000X0X00 01
10000X0 000000000001
10X0000000 000000001
10 0000	00 000	00001
1 0	0 000000X00	0 01
100	0N000000	0000001
11111111111111111111
