NO test_artifacts/valid.xpm
SO test_artifacts/valid.xpm
WE test_artifacts/valid.xpm
EA test_artifacts/valid.xpm
F 200,102,72
C 102,88,100

11111111111111111111
10000000000000000011
10000000101100000001
10000010110000000001
11010010000100010011
10101010000001000001
100100000N0011010001
10000001000000000001
11100001000000000001
10000001001100100001
10000000101000001011
10000010011000000001
10000001010110001011
10100000010010000001
11101000010000010001
11000100100001000011
10000100000000000001
10000000010110010101
10100010000001110011
11111111111111111111
