NO test_artifacts/valid.xpm
SO test_artifacts/valid.xpm
WE test_artifacts/valid.xpm
EA test_artifacts/valid.xpm
F 182,211,242
C 67,137,144

11111111111111111111
100 000000000 000	01
100000X0X0000  0X001
100000000000X0000001
10000 00 000 0 0X001
1X 00000 00X0X0000 1
10000 000000000 0001
1 0XX 0000000 0 00	1
100000 0X	0 00X00 01
1 0	00 X00X	  X00001
10 00  	0X0 00	00001
1 000000X000X0000 X1
1 X0000X	00000000001
1 X 000000X0X00000X1
1 	0000	0000000	00X1
100000	X0XX00 00 X01
100000000 00000000X1
1 0X00N0X00 0	000 01
10000000000000000001
11111111111111111111
