NO test_artifacts/valid.xpm
SO test_artifacts/valid.xpm
WE test_artifacts/valid.xpm
EA test_artifacts/valid.xpm
F 54,186,167
C 35,82,137

11111111111111111111
10000100010000000001
10100000100000001001
10000101000001000011
10000100001000001001
10100000000010000001
10110010000000001001
11000000100010010001
10010010000001100111
10010000000010000001
10100010001000001001
10000001000000000111
10000000001000000001
100000N0100000000011
10000000001000000101
10100000000000001001
10000010000000110001
10110100000101000001
11000000000100000001
11111111111111111111
