NO test_artifacts/valid.xpm
SO test_artifacts/valid.xpm
WE test_artifacts/valid.xpm
EA test_artifacts/valid.xpm
F 166,15,229
C 251,35,233

11111111111111111111
10000000X00X00	000X1
10 0X00XX0000 00X001
1X0  000000 0X0000X1
1 X00000000X0	000XX1
10 X00000X00000N00X1
10000000000000000001
10	0X0	0000000X000 1
1 0000000 	 0 000 01
100000X000000000X  1
10000 00000X00000001
100X00000000X00000X1
1 00 0000000	0	000 1
1	000000000000X00001
1000000XX 0    X0001
1000000XX000XX000001
1X0 X00X000000000001
100000	00000 0  00 1
10X000XX0X0 X00  X01
11111111111111111111
