NO test_artifacts/valid.xpm
SO test_artifacts/valid.xpm
WE test_artifacts/valid.xpm
EA test_artifacts/valid.xpm
F 40,49,149
C 73,54,189

11111111111111111111
10000X 	 00X00 00001
100000X 000000 X0001
1000 000000	000X0001
1 0 00000000 X000N 1
100000000000 00 00X1
1000	00 00	000X00001
1 00 0000000 0X00001
100X	X00	0	000 00001
1000 000000000X000X1
1X00	000X00 0 000X01
1X0X00000  00X00 001
100000X00000000000 1
100000XX 0000X000001
1000 00000 00000 001
10000X0000	000 00001
1	000000X 0XX00000X1
1X00 0	XXX 0X000	0 1
1X 0	00000 	00000001
11111111111111111111
