NO test_artifacts/valid.xpm
SO test_artifacts/valid.xpm
WE test_artifacts/valid.xpm
EA test_artifacts/valid.xpm
F 83,53,131
C 102,183,86

11111111111111111111
1	 0X0X 	00000 00X01
1000	00 0000 0000001
100	0000000000 00001
100 000	00 00 	0 0 1
1000X	0000	0	0000X01
10	0000 N000000000X1
100 000	000000 00001
10000 	00X0000000X01
1 00000000 0 0000001
1X00000000X0 	0000 1
100000 0000000000001
1	000 0 000000 00001
100 000X0 00 	000001
1 0  0 0000	00000X01
1000X0 00000000 	 01
1 00XX000000000 X001
10	0X000 000000000 1
1000000 0000 0X000 1
11111111111111111111
