NO test_artifacts/valid.xpm
SO test_artifacts/valid.xpm
WE test_artifacts/valid.xpm
EA test_artifacts/valid.xpm
F 230,69,172
C 42,113,120

11111111111111111111
10000011001000011011
10100001001100010001
11010000010000011001
10001100001010110001
10000010000001100011
10000010000000001001
10010001000000000101
10000N01000010000001
10100000000101001001
10000000100000111001
10000000000000001001
11000001000000100001
10000000001000000001
10000000001010001001
10000000101010000011
10000000100000000011
10000010001000000001
10000000000000000011
11111111111111111111
