NO test_artifacts/valid.xpm
SO test_artifacts/valid.xpm
WE test_artifacts/valid.xpm
EA test_artifacts/valid.xpm
F 235,144,122
C 223,238,120

11111111111111111111
10X00000 0000 X00 01
10000000000000000	01
1000X0X00	000 000001
10000000000000000001
10000	 0000000000001
100X00  000 00000XX1
1	XX000000000X00  X1
10 0000  0000 00  01
100000X00X0X00	00001
100 0	  000  0000001
100 0000000X0 000001
10X000N000 000X 00 1
10000000X000X0000001
10X000	 X000 X0X0 01
10	 0	00X0000 000X01
10000X0 0	000X0	0	01
1 000000X000 0000001
10X 0XX00	00	0000	01
11111111111111111111
