NO test_artifacts/valid.xpm
SO test_artifacts/valid.xpm
WE test_artifacts/valid.xpm
EA test_artifacts/valid.xpm
F 120,,0,0
C 73,68,132

11111111111111111111
1 0 N00000000X000 01
1 0000000 XX000  001
100000 0000X 000	0	1
1 	 0000000000000X01
10000000000 000X0001
10	0	0000	00XX00 001
1000000XX00000000001
10000 000	000X0X0001
100000X00X00000 0001
1X	000000000000 0001
100X 0000 00000000 1
1000	00000X X0X0 001
10000XXX 0 0X00X0X01
100000 00 00X 0 	X 1
100000000	 0000000X1
10000 00 0000000 0 1
1000000 X00X0 000X01
100 X0000000000X0001
11111111111111111111
