NO test_artifacts/valid.xpm
SO test_artifacts/valid.xpm
WE test_artifacts/valid.xpm
EA test_artifacts/valid.xpm
F 4,206,19
C 82,227,178

11111111111111111111
1 00000	 000 0000001
100X000000X00000XX01
10000000	0X00X0000 1
100000000 00000000X1
10XX0000000 0X0 0001
1 00X0000000000000X1
10X00X000 00000 0001
1	00000	 00 00000001
1	0000000X 0X0000001
100X0000 X0000X00001
1000X00  	0000000001
1000X00X 000X000 0 1
1 0000X00  0	000 001
10		0	000 000X000001
1XXX000N0 00000XX001
100 00000	0 00   001
1 0 0 000 00000000 1
10000000000000000001
11111111111111111111
