NO test_artifacts/valid.xpm
SO test_artifacts/valid.xpm
WE test_artifacts/valid.xpm
EA test_artifacts/valid.xpm
F 52,50,229
C 191,90,78

11111111111111111111
10000 00000000000001
10 00 	000000000	X01
100000 0000X00000001
10 0000000000		00001
10000000000000	00001
1000 0X000X000000 01
100000	000 000000X01
1000000X0000 0 X0 01
10	 000X000000000001
10000X00000000000001
1000 0 0 X00000X 001
10X000 0X0X000000001
10 	0X00 X X 0000 01
1000XX	0000 0X 00001
10000X N00X0000X0001
100 0X0X000X00X00 01
100 00 0000000000001
1000 00X0000 0000001
11111111111111111111
