NO test_artifacts/valid.xpm
SO test_artifacts/valid.xpm
WE test_artifacts/valid.xpm
EA test_artifacts/valid.xpm
F 204,,0,0
C 36,46,191

11111111111111111111
1 000	00 00X0X0X0001
1000X0X00 00X0000	01
1  00000 000000X0001
10 0	0X	0000000X0001
1XXX0	000	0000 00001
1000000000 000000001
1XX00000X000 	0	 001
1XX000X0000 XX0X0X01
10XN000	00X0000X0 01
1000 000X0000X000001
1000X000000X00 00 01
1000000X0 0000000001
1X00 00XX000	00X 	01
1   000000000 0000X1
1X00X00000  00000 01
1X0000	0000000	00001
100	X0X0000	000	0001
1000X0X00X0000X0X	01
11111111111111111111
