NO test_artifacts/valid.xpm
SO test_artifacts/valid.xpm
WE test_artifacts/valid.xpm
EA test_artifacts/valid.xpm
F 152,22,218
C 185,190,72

11111111111111111111
10100011001010000001
11000000001000000011
100N0000000010000101
10000000000000101111
10100001001000010011
11101100010011000101
10000000100001000011
10000000011100000001
10000000000000000001
10001000000100000001
11000001000001100101
10001101000100100001
10000000000110000011
10000000000100000001
10010100000000001001
10110101011000000101
10011000100011010101
10000000000000100011
11111111111111111111
