NO test_artifacts/valid.xpm
SO test_artifacts/valid.xpm
WE test_artifacts/valid.xpm
EA test_artifacts/valid.xpm
F 83,157,134
C 184,225,255

11111111111111111111
10000X00	 	00	0	00 1
10000000000	00000 01
10000 00X0 0X000 001
1	X00X	00X		0 000001
100 X000X0 	000X0001
10000 00000 0XX000	1
1 0000000X0 0XX000 1
1000	X00	00X00000001
100 00000000XX000001
1X0	X0 0000000X0	001
1000X0X000 	00000	01
1	00000000	00000 001
10X00000000	0 000 01
1000 000N000X0000X01
10X0	00 000000000  1
100000X0 000X 0000 1
100000000X  X00X00X1
1000 0000 	00X0 0001
11111111111111111111
