NO test_artifacts/valid.xpm
SO test_artifacts/valid.xpm
WE test_artifacts/valid.xpm
EA test_artifacts/valid.xpm
F 66,0,0
C 98,122,249

11111111111111111111
1000 0000000000	  01
10X0X00000 000X00 01
10X0000 0000XX00X001
10X0X00	0000000	0001
1000 X0 000   0000X1
10000000000	X0000X01
10000000000XX00	0001
1	0XXX	0	00 X	0 	001
1000X000X000000	0001
1 0000 00X0000000 X1
10000000 0	0 0000001
1X0 0X000	0XX00	0001
10X00000000X0X0 0001
10 000X 00	000  0001
1X00000	X00000X00001
1X0 X00000	X0 000001
100000	0000X0N000001
10 00XX00000000 0001
11111111111111111111
