NO test_artifacts/valid.xpm
SO test_artifacts/valid.xpm
WE test_artifacts/valid.xpm
EA test_artifacts/valid.xpm
F 72,,0,0
C 170,170,169

11111111111111111111
10X00000X00 0X0X0001
1	0000 00 000X0X0 01
10	0000000000000X001
1X00000000X00000X0N1
10XX000X0X  0X00	001
10X0000000000X00X 	1
100000 0000000 00001
100X000	00X	0	00 001
10000000 00000000001
1000000 0000000000X1
100000X000	00 0 X0X1
1X000X0000X000000001
1X 000000000000X0001
1 0	00 0000000000 01
100	000000000000X001
10 000X	000X00000001
10X 00  00000X00 001
1000	00X0000X00X0001
11111111111111111111
