NO test_artifacts/valid.xpm
SO test_artifacts/valid.xpm
WE test_artifacts/valid.xpm
EA test_artifacts/valid.xpm
F 62,88,191
C 104,153,156

11111111111111111111
10000010000100001001
10010000000000000001
10000000001010100001
11100101010000000001
10100000001100000001
10011000000000010111
11010000000010100001
10001000000001010011
10000011000010000101
10000000010000010101
1000100000100N010001
10001010000000000011
10000100000001010001
11010100100001000001
10000000001000001001
10100000000000001101
10010000000001000011
10000000100000100001
11111111111111111111
