NO test_artifacts/valid.xpm
SO test_artifacts/valid.xpm
WE test_artifacts/valid.xpm
EA test_artifacts/valid.xpm
F 66,148,54
C 132,56,195

11111111111111111111
10100010110000000101
11010000000000000001
11000000000000000001
10000110101000100001
10110010001000010001
10100000110000000111
10010000110000000101
10100000000001000001
10000000001000000001
10000000000010000111
10000101000000000011
10110000100000000001
10110100010100001011
10010000000000010001
1000010100000N000001
10000011100000001111
10000000000000000001
11001001000101111011
11111111111111111111
