NO test_artifacts/valid.xpm
SO test_artifacts/valid.xpm
WE test_artifacts/valid.xpm
EA test_artifacts/valid.xpm
F 247,120,201
C 14,45,54

11111111111111111111
1000X0	000 X0 000001
1000X000X0X000 X00X1
100X00 00	000 0X 001
1000X0	 000000000001
10X000X00 0000000 X1
1 0X0000	000000	00 1
1000 X0XX00X000000X1
1	0 000000 000X00001
10X 00000X0000 0X001
1000000	000X0000X001
1 0X0000000X00X00001
1000X0	0000000000001
10000XX0X000000000X1
100000 000  00000001
1 X0X 000000 0000001
100		0000 X000000001
100000000X0	00X0 001
10000X0	000000 000N1
11111111111111111111
