NO test_artifacts/valid.xpm
SO test_artifacts/valid.xpm
WE test_artifacts/valid.xpm
EA test_artifacts/valid.xpm
F 193,,0,0
C 165,90,132

11111111111111111111
100	 0 00XX000000001
10000000000000 00001
10XXX00000 000000X01
1000	X0	0X0X 00000X1
1	00000	X000000X0001
10000000	X0 0 0	00	1
100 0000000X00000001
10 00000000 0X0000X1
10000XX  00X0 0000X1
1X0 0 0X000	00X00X01
1X000000000X0	0X	001
1000	0000000000 0001
10  0000	00000	00001
100 000X 000000X0X01
100 0  0000000 00001
1	0000X 0000000000X1
100 0 X00N00X000 X01
1	00000X00		0	000001
11111111111111111111
