NO test_artifacts/valid.xpm
SO test_artifacts/valid.xpm
WE test_artifacts/valid.xpm
EA test_artifacts/valid.xpm
F 22,209,240
C 171,148,253

11111111111111111111
10000000000010100001
10000001000000000011
10001000000110101101
10000000000010000001
11000110000000000001
10000110000000000001
10000000110000010001
11000000000000100101
10000000001100000001
10000010000110100N01
10000011011000000001
10000000000001010101
10000001010001000001
10010010000100000111
11000001100010000001
10000101000100000011
11011100000000000001
10000000100001000001
11111111111111111111
