NO test_artifacts/valid.xpm
SO test_artifacts/valid.xpm
WE test_artifacts/valid.xpm
EA test_artifacts/valid.xpm
F 164,57,178
C 181,222,155

11111111111111111111
10000001100100001001
10000001000000100101
11001010000010000001
10100000100001000101
10000000010001100001
10000001000100001001
10001000000001001001
10000000000000000001
100000101000N0111001
10100010000000001001
10000000100000000001
10111110000001000001
10000000100000000001
10000000000000000001
10000000100001000001
10010000000011000011
10110100000000110111
10100000100001100001
11111111111111111111
