NO test_artifacts/valid.xpm
SO test_artifacts/valid.xpm
WE test_artifacts/valid.xpm
EA test_artifacts/valid.xpm
F 24,,0,0
C 25,226,138

11111111111111111111
10	0X00	 X  0 000001
1 000000	00 0000   1
1X00	00  00000X X001
10	000XX	00000X00001
1000000	000X00000001
1000 000N0X000X00001
100000000000  000001
10000 0XXX0 0 X 00 1
100	000	00000000 	 1
10X0 	0	00000 00X001
1X 0	000 0000000 0 1
10000000000000000001
1 0000 000000	0 X001
1000000000000000X001
100 000 000 	0 0 001
10000X000000	00 0X01
1 	00 	 0X0000X00001
100X	0000000 0000001
11111111111111111111
