NO test_artifacts/valid.xpm
SO test_artifacts/valid.xpm
WE test_artifacts/valid.xpm
EA test_artifacts/valid.xpm
F 80,0,0
C 141,119,81

11111111111111111111
100000000000000  001
1	0 0	X000 0000 0X01
1000 	000X0000 00001
100 0 0000000000XX01
10 0000X0000000000 1
10000X00000000000X01
100N000000000 0	0001
1000X000	X00000 00X1
10000000000X0000  X1
1000000	000000X00001
100 X0000X0	0 00	0	1
1X000000X0000000 001
1000X00	 000000000 1
1 0000000X00 000X0X1
10 00	 00 0000000X01
1000000 00  00 0 0X1
1 0X 0X000000	000001
100 000X0X00000	0001
11111111111111111111
