NO test_artifacts/valid.xpm
SO test_artifacts/valid.xpm
WE test_artifacts/valid.xpm
EA test_artifacts/valid.xpm
F 202,184,167
C 15,6,213

11111111111111111111
10000001010000000011
10000000100110100101
10000000010000110001
10000000000000100001
10000001000000001001
100N0000000010010001
10000100001001011001
10001000100011000001
10000000000001001111
10000010010011110001
10010000000100100001
10000100000000001001
10001000000010100001
10000001001001000001
10001000010000100001
11001000100001000001
10000010000000010001
10010010101100010001
11111111111111111111
