NO test_artifacts/valid.xpm
SO test_artifacts/valid.xpm
WE test_artifacts/valid.xpm
EA test_artifacts/valid.xpm
F 245,109,103
C 14,223,44

11111111111111111111
10000000000000000001
10000100000000000001
10100001111001000001
10010001011000110001
10001100000000100001
10110000000010100001
10000100000001001001
10101100101001000101
11000000000000000111
10001001010101000011
10000001100000000101
10000N00100011001101
11100000101000000101
10000010001000000011
10000000010010010001
10010001000000000001
10110110000100000101
11010000100000000011
11111111111111111111
