NO test_artifacts/valid.xpm
SO test_artifacts/valid.xpm
WE test_artifacts/valid.xpm
EA test_artifacts/valid.xpm
F 134,255,11
C 165,253,12

11111111111111111111
11000000000000010001
11100010000000000001
10010001000000100101
11010100000000001001
11010000000000101001
10001000001000000101
10000010000001100011
10000010001011000001
10000001100000000001
11000001110000000101
10110101000001010001
10100000110000000011
1000N010001000011101
11000000000000100011
10100000000000000001
11000001110000000101
10000000101000000001
10001001000000101001
11111111111111111111
