NO test_artifacts/valid.xpm
SO test_artifacts/valid.xpm
WE test_artifacts/valid.xpm
EA test_artifacts/valid.xpm
F 237,137,229
C 165,123,67

11111111111111111111
100X0000000000000001
100 000000000X000001
1000X	00X	000	0X0001
100X00000X 000 0	001
10 0000 00000N0X0 01
1X000X0X000000 0 0 1
100 00	0X000000000	1
10 	0	X000000X000001
10000 00 0X 	0000001
10X0   00 000 0 	001
100 000000X0X0000001
1 0X0 000XX000000 01
1000X 00000000000001
10X000	00	0000000001
1000X000000  0000001
1000 0000	X0 XX00001
100000XX000000	000 1
10	0	0000000X 000  1
11111111111111111111
