NO test_artifacts/valid.xpm
SO test_artifacts/valid.xpm
WE test_artifacts/valid.xpm
EA test_artifacts/valid.xpm
F 38,242,228
C 246,137,76

11111111111111111111
100X00000000 0X000X1
10 000000000000	0001
10000	0000 X000000	1
1  000000000000X00	1
1X00000		0	00X000001
10000 00X0 00 00	001
10000000X000000	0 01
1X 00000	00NX	 X 0 1
100000	X 0000000 0X1
10X	0000XX 0000 0001
10 0X0000 X000000001
10X0000000 0000 00 1
1000000X 0000  X00X1
1 000XX000	000000001
1000	 00000000000001
1000000000	X	00X00X1
1 000000	000X  00001
10000 000000000 X001
11111111111111111111
