NO test_artifacts/valid.xpm
SO test_artifacts/valid.xpm
WE test_artifacts/valid.xpm
EA test_artifacts/valid.xpm
F 43,242,31
C 59,57,176

11111111111111111111
10001000000001001001
10011000100000000001
10000000000000100101
10100010000N01000001
11010010100000000011
10000000100000001101
10001000000000011011
10010000100000000001
11000001000000000111
11000000010100000001
11000111011000100001
11001010100000000001
10101000000100001001
10100000000000100011
10001101000000001101
10101110000000000001
10000000000000000101
11000000110100010001
11111111111111111111
