NO test_artifacts/valid.xpm
SO test_artifacts/valid.xpm
WE test_artifacts/valid.xpm
EA test_artifacts/valid.xpm
F 163,255,52
C 124,31,40

11111111111111111111
10010000000000000001
10000000000000001001
10010000000000000001
10110N00000000000001
10000000100100000001
11000000010110000001
11000100000000000001
10010011000000000001
10000001101000000001
11000010010000001101
10101100000000010001
10001000000011000101
10101000000000001011
10000100010000000001
10000001010000000001
10101010000000000101
10000011000000000011
11000010010001000101
11111111111111111111
