NO test_artifacts/valid.xpm
SO test_artifacts/valid.xpm
WE test_artifacts/valid.xpm
EA test_artifacts/valid.xpm
F 19,177,145
C 74,239,212

11111111111111111111
1 00X000000	000000X1
1	000X 0000000 00X01
1 	0X	000  0000X 001
10000000000	00X00X01
100000 XX00000 	00X1
10000 00000000X00	01
10000000	00000000  1
10000X000X0X000X0		1
1X 000 0X0000 000001
10000000X00   000001
1000000		000 X000001
1 0 00	000	 00000X01
1 X00 0X000N 0X000	1
1000000000X0 000X 01
1X000 0 00 0  000001
10000000X0	00 0000 1
10000000	 00X00	X0X1
1X0000 00000X00 00X1
11111111111111111111
