NO test_artifacts/valid.xpm
SO test_artifacts/valid.xpm
WE test_artifacts/valid.xpm
EA test_artifacts/valid.xpm
F 188,172,10
C 138,48,250

11111111111111111111
10100100000000010101
11000001000101000001
11000000000000000001
10001001100001000001
10010000010000000011
11000000001000000011
10000000001000100001
11001000010000000011
10000100000000001001
10001010001010001001
10001000000101000001
10010010100000010001
10000111000N01000101
10001001000000000001
10010010000000000001
10010101100000000101
10000001000000000001
10000100100000000001
11111111111111111111
