NO test_artifacts/valid.xpm
SO test_artifacts/valid.xpm
WE test_artifacts/valid.xpm
EA test_artifacts/valid.xpm
F 149,57,232
C 24,180,100

11111111111111111111
100N000X0 00 00 0X 1
100000X00000 	00X001
1	000 00 00000	00001
10000 0X0000000 0001
100000000 00 00 0001
1000 00000X00 000X01
100000000	 0000X0001
1000 0000XX0000 00	1
10000X0	000000X000 1
10X0X00 0X0X00 00001
1000 X000000 X 00 01
10  0X 000000	0X0 01
10X00X00 0000X00 001
1000 0	00X0 00X 0001
10	00 0X000 0X 00001
10	 000000X000X000X1
100000000000 X00  01
1 0000X00X00	0000001
11111111111111111111
