NO test_artifacts/valid.xpm
SO test_artifacts/valid.xpm
WE test_artifacts/valid.xpm
EA test_artifacts/valid.xpm
F 205,0,0
C 165,39,70

11111111111111111111
1	0000X0X000	0X000X1
100 0X0	0000000 X001
10	00000000 00XX00X1
10	000	0	00000	XX0 1
10000X 000000 000001
1000 0000000 	0   X1
1000000X00 0	0000 01
100000 0 000X 0	 0 1
10X00000000 000000X1
1 X00	X0 0000X0	0X01
10000 0000 00 00 001
100000 00000X 0XX001
100X0 0000000000	 01
10000000 000000 	001
1N00 0 00000	0000001
10000 000000 00X0001
10 0000	00000XX00001
100	 000 0000000X0X1
11111111111111111111
