NO test_artifacts/valid.xpm
SO test_artifacts/valid.xpm
WE test_artifacts/valid.xpm
EA test_artifacts/valid.xpm
F 100,73,231
C 5,240,76

11111111111111111111
10000000	00 0000N001
100X00000000X00X00	1
10 000000 0 0 0	0001
10X000X0		X0000 0 01
1XX00000	0XX00X000X1
1000X 0 0000 0000 X1
1		 0 00 00000000001
100  	00 0X00000 	01
100000 00X000X000001
1 0X00 0  0000XX	001
10000000000000 00 01
1X00X00	0000 00 00 1
1000	00XX00000000001
1	00000X0XX0000000X1
100X0X00 	 000 00 01
10000 0000 0X0000001
1000X00000000  00001
100000XX0X0000 X X 1
11111111111111111111
