NO test_artifacts/valid.xpm
SO test_artifacts/valid.xpm
WE test_artifacts/valid.xpm
EA test_artifacts/valid.xpm
F 31,0,0
C 61,171,155

11111111111111111111
1000X000000000000001
10X0000000X00 0000X1
1X000X	X00XX 0000001
10	N0000XX00XX X0001
10000X0X00X000000 X1
1	000X000 0000000001
1  00	0 0000X0 0 001
100X0000000 X0000X01
100X000000 00X000001
1X0000000X0	00000001
10000	00000X00000X	1
1 0000	00000000X 0X1
10X0X000 	00X 0X0001
100 0000000X00X0 0X1
1000	000X000 X0	0001
100X0X000000X00X0001
1 0 	0X000000000X001
10 000000  000000 01
11111111111111111111
