NO test_artifacts/valid.xpm
SO test_artifacts/valid.xpm
WE test_artifacts/valid.xpm
EA test_artifacts/valid.xpm
F 116,217,161
C 62,7,16

11111111111111111111
10000001011100000001
10001100101000000001
10000000000111101011
10000000001001000011
10000001100000000101
10000000000000000001
10000000010001001001
10110010000000000001
11100000000101100001
10001000100000100001
11000000001000100001
11000011010000001001
11001000100000000101
10001001100010000001
1011010010N001000001
11000001100000100011
10110110000000100001
10000000011001000001
11111111111111111111
