NO test_artifacts/valid.xpm
SO test_artifacts/valid.xpm
WE test_artifacts/valid.xpm
EA test_artifacts/valid.xpm
F 183,35,213
C 250,203,235

11111111111111111111
10010100110000100101
10000010000000000011
10000100001000000001
11000111000000000001
10000101010000000001
10110000100010000011
11000101000000000011
10000000010000100001
10100110100000000001
10000000000000000001
100N0100100000001101
10000001000101000001
10110000000011010101
10001101100001000001
10101101000100011001
10000000000000000001
10000010010010000001
10000000000111000111
11111111111111111111
