NO test_artifacts/valid.xpm
SO test_artifacts/valid.xpm
WE test_artifacts/valid.xpm
EA test_artifacts/valid.xpm
F 120,,0,0
C 255,197,13

11111111111111111111
1X0X	X0000000	00 001
10 0X0000	000	000001
10000000	00 X000 X01
100000000000X 0000 1
1000 000 000	00X0001
100	0XX00000000X	001
10000000	0X0	00	0 01
10 00X000X 000000001
100000000000 0000 01
100N0 0000X0	X0X0	 1
10X0000X0X0000 000X1
10X00000 00000 00X01
1XX000X00X000 000001
1	0X00000000 0 00 01
100 0 0 0000000000 1
1X000 0X0000000 0 X1
100000000000000X0001
10XX0 0XX000XX0X00 1
11111111111111111111
