NO test_artifacts/valid.xpm
SO test_artifacts/valid.xpm
WE test_artifacts/valid.xpm
EA test_artifacts/valid.xpm
F 23,243,142
C 164,156,252

11111111111111111111
10 0000 00 0000000X1
1000000000000000 001
100	00000	0	X0X000	1
1X0000X00000000 0001
1 00000000000 00 001
1  X0X	00 0 0	0X0X 1
100 0	00X0 00000	0	1
1000000000X000X 00X1
1X0000000000000000 1
1 000000000 0000X001
1000000000000 000001
10X 000000	000000X01
10 000 000X0 0000001
1X000	0X000 0X000001
1000000X 0XX000	 X01
100X 00 000	00	00X01
1000 0	0X0N 000000X1
1 0000 000000	000X01
11111111111111111111
