NO test_artifacts/valid.xpm
SO test_artifacts/valid.xpm
WE test_artifacts/valid.xpm
EA test_artifacts/valid.xpm
F 68,0,0
C 114,212,246

11111111111111111111
100000000000 000 0	1
1000000	0 000X00 0 1
1  000 00000X00	00 1
1	00000XX00 0	000001
1000000 000 0000X001
1X0000000 000X000001
100X000	0X0 0	X000	1
1000 X	00000000	0001
1	X0000	000000000001
100X00 000000	 000 1
100000 0000000000X01
10000000	 0000 00001
100	00000	0000000001
10 00000000000	00 01
1 0000 0	0000X	 00	1
1X0000XN X00000 0001
1000000X0000X0000001
1XX00000X00000X00 01
11111111111111111111
