NO test_artifacts/valid.xpm
SO test_artifacts/valid.xpm
WE test_artifacts/valid.xpm
EA test_artifacts/valid.xpm
F 24,195,24
C 136,221,42

11111111111111111111
10000000000000000001
10000000000101001001
10101010001000000001
10110100000100000001
10100111000000000101
10001010000000100001
10000100000000000001
11100000000000000001
10000000010001000011
10001001010010000001
10000000000010100011
10000000000001000011
10010100010000000001
10010000000110011001
100100000N0001000001
10001000000000001001
10100000001000001001
10000001010010010011
11111111111111111111
