NO test_artifacts/valid.xpm
SO test_artifacts/valid.xpm
WE test_artifacts/valid.xpm
EA test_artifacts/valid.xpm
F 162,,0,0
C 52,128,139

11111111111111111111
100 00 00XX000000001
10 00	0000X	0	000001
10000 00X00000000001
10X	 XX000	00  0 001
100 00000	0X0   0001
10 X000X00000 0 0001
100000 00000	000X001
1 0	X0	00000 	0000X1
10X 000000X0X0000001
10000000000 0X 00X01
1000 0000  00 000001
10  00 0000X000000 1
10  0000000000000X01
10 00X00000000000001
10000 00000X00 X0X01
10X00000N000000	0001
1000	0X00000XX 00 01
1 0X00	0000000	00001
11111111111111111111
