NO test_artifacts/valid.xpm
SO test_artifacts/valid.xpm
WE test_artifacts/valid.xpm
EA test_artifacts/valid.xpm
F 139,50,196
C 227,13,205

11111111111111111111
1 X0	00  00 0X0N0	01
100 	0X00000000X0 X1
1 X0000000XX00 	0X01
1X0	0XX000 0000	0001
100000X0000 0X0000 1
100 00000X000X000  1
10 000000X	000	00001
100 	X00	00000000001
10000 0000000000 001
1000000 00	000X 0X01
100 00000000 XX00001
10X000000XX000000001
1 00	X	0000X0X 00001
100X0 0X000X0	0XX001
1 0	000XX000 0X000	1
100000 0 00000 00001
10X 000000	000000001
1 00 0XX0X00 0000X01
11111111111111111111
