NO test_artifacts/valid.xpm
SO test_artifacts/valid.xpm
WE test_artifacts/valid.xpm
EA test_artifacts/valid.xpm
F 229,48,117
C 98,55,223

11111111111111111111
100000000000  0 0X01
10	 	00 000XX 0X0X01
100	0000000X	00000X1
1	0X00X0000000	000	1
100 0000000000000X01
10000X00000000000001
10 0 000000000	0 001
1000000000  000	00	1
10000000X0X0000	0001
10  00000 X00X000001
10000X0000N00000	0 1
10000000000000 00	01
1 000	0000X000 00 	1
10000000 00X0 00X001
10000XX0000000X0 X01
1 000XX000000X000 X1
1000X	00 000000 0	01
10X0 	0000X00000X0	1
11111111111111111111
