NO test_artifacts/valid.xpm
SO test_artifacts/valid.xpm
WE test_artifacts/valid.xpm
EA test_artifacts/valid.xpm
F 18,185,193
C 120,251,33

11111111111111111111
100X00 X 0	 00X00	01
10000000X X000X000X1
1X00 0X0X0 000000001
10000000000000X 0001
10 XX000	 0XX0000X01
100 00000XX000000 N1
10XX000 0000X00X0001
10000000	0	 00000001
10000000 0X000		00X1
100000X00X000XX000	1
10000XX00000X0XX0001
100X0000X0X00X0 0001
10 0	X000000000X00X1
1000	00000000000X001
1 X 000000X000X0	001
1000000000 00	000X01
1XX0000000000X000 01
1X X000X00000000X001
11111111111111111111
