NO test_artifacts/valid.xpm
SO test_artifacts/valid.xpm
WE test_artifacts/valid.xpm
EA test_artifacts/valid.xpm
F 1,219,156
C 218,223,111

11111111111111111111
10110000100111000001
11101000110000010001
10010000000011010001
11000000000000000N01
11000000000000010001
11011000010000100101
10000110010000001001
11000000000000000011
10100001001000000001
10000000000001000101
10100000100001000001
10000010000010100001
11000000000000010001
11000001000000011101
10001000000001000001
11000001001000100001
10000000100000001001
10000010100110000001
11111111111111111111
