NO test_artifacts/valid.xpm
SO test_artifacts/valid.xpm
WE test_artifacts/valid.xpm
EA test_artifacts/valid.xpm
F 0,54,150
C 45,35,183

11111111111111111111
10000100110000000001
10000011000000101001
10000100000000000001
11000000011000000001
11001001000000001001
11001000010000010011
100000000000N0110001
10000100100000001101
10010000010000011001
10000000000001000001
10000000000001000001
10100010101110000001
10011110100100010001
11000000000100000001
10011100000000100011
10000000001000000011
10000001000000110001
10010010111000000001
11111111111111111111
