NO test_artifacts/valid.xpm
SO test_artifacts/valid.xpm
WE test_artifacts/valid.xpm
EA test_artifacts/valid.xpm
F 139,124,219
C 60,171,123

11111111111111111111
1X 00 0	000000000001
100000000 0	X0X00001
100000000X0000	00001
10X0000000X000	0XX	1
1	0 00000000000	0001
10000N000000X0 00001
100000 00 00000XX001
100000X000 X 00 X001
1	0XXX00000000 X0X01
1000000000X0 00000	1
10 0XX 0000000000001
100000000	00000X0001
1	000000000000X00001
1 0X00000 0 00	00X01
1	X000000000000000 1
10X000X00	000X	X	001
10	0	00000  00000X	1
10	00	0000000	000001
11111111111111111111
