NO test_artifacts/valid.xpm
SO test_artifacts/valid.xpm
WE test_artifacts/valid.xpm
EA test_artifacts/valid.xpm
F 14,,0,0
C 29,229,175

11111111111111111111
100 0000000000000001
10000000	X0X00  0001
10X00 00 000  0	N 	1
1   00XX000000000001
10 00X000 0000 0X001
1000X0000	X000000001
1000000000X000000001
10 X00000000000X0001
1000000000XX 0 000	1
1X X0	000 00 0000001
1000X	00000000X 0001
1000	0000X0 0	00X001
1X0000 0 0XXX0 00001
100	00X00X0X000 0001
10000   000000  0	01
100 00000 0000000001
10000000000000 00 01
1000 000 00 00 0 0X1
11111111111111111111
