NO test_artifacts/valid.xpm
SO test_artifacts/valid.xpm
WE test_artifacts/valid.xpm
EA test_artifacts/valid.xpm
F 263,0,0
C 146,103,104

11111111111111111111
100X000	00000X00X0X1
10000 0	00 000	00 01
100 000000  000 0001
100X000000000 000001
1000	00000000000 XX1
1000X000000X0XXX0X	1
1	000 000	00000000	1
10000000 0X00X0000X1
1 000000000NX00	 001
1 X00	0000000X000 01
10 00	00000	0	000  1
10000000000000 00X01
100X00 0000000000001
1000000	00000000X 01
1X00000 X X0X0000001
10000XX00000000X0001
1000000000XX0X	00001
100000X0X 0	000 0001
11111111111111111111
