NO test_artifacts/valid.xpm
SO test_artifacts/valid.xpm
WE test_artifacts/valid.xpm
EA test_artifacts/valid.xpm
F 212,212,86
C 217,111,103

11111111111111111111
10000X0000000 00 X01
10  0	0  00000000001
10000000000 000 0001
1 000000 00000X0 001
1000X000X00X	 	0	  1
10000  0000		00 00	1
1000 		0000000 000X1
1X0 0 0000 000 00001
1000000000	0	00	X001
10N00 0	X0X0X000 001
1 00  000 0000000 01
1	000XXX0000X0000001
10X	0000000000000001
1000	00X000X000XX0 1
1 000000000X00	0XX01
10 0000000	000000001
1000000000 00X0X00X1
1	0000 0X0 000000001
11111111111111111111
