NO test_artifacts/valid.xpm
SO test_artifacts/valid.xpm
WE test_artifacts/valid.xpm
EA test_artifacts/valid.xpm
F 177,230,2
C 215,241,47

11111111111111111111
10000000000000011001
11000000000000101001
10001100100101000001
10001000000101000101
10101000010000000011
10011000000000100001
10001000001000000001
10000000000000100001
1010000000000000N001
10100000000011100001
10110000000000001001
10010100000001000001
10000011010001000111
10001000110001100001
10000110100010000001
11110000100000000001
10110000000000100011
10000101100010100001
11111111111111111111
