NO test_artifacts/valid.xpm
SO test_artifacts/valid.xpm
WE test_artifacts/valid.xpm
EA test_artifacts/valid.xpm
F 63,32,169
C 40,18,124

11111111111111111111
10000000101010010001
11000110000100101001
11000000000000010011
10011000101000000001
11100000000010000101
10000111010100101001
10010000100000000111
10000001011000000001
10000000000010100011
11000010000100000011
10110000101010000011
10100100000010000001
10001000000000000001
10001000000000000001
10000000100000010001
1000N010001000000001
10000000000000010001
10000000000110100001
11111111111111111111
