NO test_artifacts/valid.xpm
SO test_artifacts/valid.xpm
WE test_artifacts/valid.xpm
EA test_artifacts/valid.xpm
F 97,6,49
C 15,182,210

11111111111111111111
10000000000000000001
10111100011100001001
10100000000110001001
10000110101000010011
10000000000001101001
10100000100000000011
10011101010N01001001
10000011100000011001
10000100101000000001
10001100000000110011
10001100000110000011
10010100001000011011
10001000001010000101
11000101010000001001
11001000001010000001
10101011001000001011
11000000010000010001
11100101001100000011
11111111111111111111
