NO test_artifacts/valid.xpm
SO test_artifacts/valid.xpm
WE test_artifacts/valid.xpm
EA test_artifacts/valid.xpm
F 221,237,92
C 203,149,190

11111111111111111111
1000000X00000000 0	1
1X000	00 00	0	00	001
1 000	X 000000X00001
1	0000 00000XX0X0 01
10		0000X000000	00X1
100 000000X	 XX00001
100000		X0 0 0000001
1000N	0000		000000	1
1X00	X 000 		0000001
10X00 0X0000000 0001
1000X	00X00X 0000001
1000	00000000X0	0001
1 000X000000X0000001
100000	 00X00X000 01
1000000000000X000001
1000	X00  0 000000 1
1X00 00 000000X00001
1000000	000X0  00001
11111111111111111111
