NO test_artifacts/valid.xpm
SO test_artifacts/valid.xpm
WE test_artifacts/valid.xpm
EA test_artifacts/valid.xpm
F 110,0,0
C 228,88,200

11111111111111111111
10X0 00000 0000000X1
1 00 0000XX0000000 1
100	0000 	 00 000001
1000 00000 00000X001
100X00000 X0000 0001
10 X000 000X00 000 1
100	00	000000X000001
100000X0X0XX000000	1
100000 X00000000X001
100000000X00 00X0NX1
1 00X00X000X0X000001
100 X		0 00X00000001
100 0 X00	0 00000X01
10000X 0X00000	0  01
1 000000X00000000001
100 0000000000000001
10X0000000X0X X00X01
10X0X00	X		00 000X01
11111111111111111111
