NO test_artifacts/valid.xpm
SO test_artifacts/valid.xpm
WE test_artifacts/valid.xpm
EA test_artifacts/valid.xpm
F 8,123,233
C 105,77,44

11111111111111111111
10000110100000000101
11010111110000000101
10000010000010000001
10000000000000111101
10001000000100000001
10000000000000000001
10000100100000000001
10010000000001001111
10000000001000000111
110010000000N0010001
10000010000000100011
11000100000000000011
11010000000000100101
10000000000000000001
10000100000001000001
10001000110010001101
10000101100000000001
10011000010000110001
11111111111111111111
