NO test_artifacts/valid.xpm
SO test_artifacts/valid.xpm
WE test_artifacts/valid.xpm
EA test_artifacts/valid.xpm
F 260,0,0
C 14,216,229

11111111111111111111
1	X 000XX000 0000 01
100 0000X0000X000001
10 00000000000000001
1000X00 00N0000X0	01
1000 0	0000 000 X 01
10 X0000  00000X0001
10000X00 X000X	00001
100000X	00X0 0	00001
10 0  0X0	0000 00001
10 000	00  00 X00X01
10X00000	0 000 000	1
1 0	0000000  0000001
1X00000	X00000000001
100000X 0000   00X 1
1X000000000X00000	01
1 00XX000000000000X1
100	 	0000000  0 X01
100 0000000X 0000X01
11111111111111111111
