NO test_artifacts/valid.xpm
SO test_artifacts/valid.xpm
WE test_artifacts/valid.xpm
EA test_artifacts/valid.xpm
F 140,234,84
C 29,173,85

11111111111111111111
1000	000000X0X000X01
1000000	0000X	000X01
1000X0 0	000X0 X0001
100X X0000	00 0	  01
1 	000000X0000 00001
10000	000000X000 001
1X00 00N 00000000001
1	0X0000000X00000X01
10	0X X0000X000  001
10X00000 0		X0000001
100000	0 000000  	01
1 0000000 00 0000001
100X	X00	000000 0X01
100X0	00X00000XX00X1
1XX00	X0000000000001
1000X0X0 000000000X1
100000 000000X0XX001
100	000X000 0X0 0001
11111111111111111111
