NO test_artifacts/valid.xpm
SO test_artifacts/valid.xpm
WE test_artifacts/valid.xpm
EA test_artifacts/valid.xpm
F 185,0,0
C 112,138,100

11111111111111111111
10X0 X00 0000X0X0001
100000000X0X00000  1
1 00 0 0 0000 0000 1
1	00 XX00000000000X1
10	00 0000X 00000001
100	X0 000	0X0X00001
1000X00X00000000XX01
1X0X 0000  0	0X00  1
100 00000000000000 1
1X0 00 X0 X  0XX0	01
100000000X000 0 00X1
1X0000 00X 000 00001
100000 00 	000000001
100000000	XX0	00X001
100	000000000 000001
100000 0 00000000001
10000000XN00 0000001
10X0	000000000	00 01
11111111111111111111
