NO test_artifacts/valid.xpm
SO test_artifacts/valid.xpm
WE test_artifacts/valid.xpm
EA test_artifacts/valid.xpm
F 98,206,128
C 149,205,17

11111111111111111111
100000000 000	000001
10000X000000000X0001
100	000000X0X0000001
10 00X00000X00	00001
100	00000 XX0X0 00 1
1X000 000X0000 00001
1	 X0 00000000X00001
10 0000000000X00X0 1
10000000   0 000	 X1
1X00 00 0 	00	0 00	1
10X0000	0000000 	001
1 00 0 0NX	000000001
1 000000000000X000X1
10000000000	0X0X 	X1
10 0	 000000 00X0001
1 X00	0000 00X0X00X1
10X 00 0 0 0X00 00 1
10X0	000X00000	00001
11111111111111111111
