NO test_artifacts/valid.xpm
SO test_artifacts/valid.xpm
WE test_artifacts/valid.xpm
EA test_artifacts/valid.xpm
F 30,67,114
C 254,143,56

11111111111111111111
10001001000000000011
10000000010001010001
11010000000000001001
11000000110001010011
10000000000000010001
1000010000000N000001
11100000000000000001
10000000000000000011
10110000000001110001
10110000011100100001
10000011010000000001
10001010010000111011
10000100010000100001
10000000000111100001
10000000000000000001
10000010000000100001
10000100001100000001
10010000000100000001
11111111111111111111
