NO test_artifacts/valid.xpm
SO test_artifacts/valid.xpm
WE test_artifacts/valid.xpm
EA test_artifacts/valid.xpm
F 62,29,28
C 58,201,99

11111111111111111111
10X 000 0XX0 0000 01
10X00	0 00 0000000X1
100 0		X 0	0X X00001
10000000000000X	00X1
100	0000 0	00X00X 01
1000X 0X000 0 0X	0 1
10000X X0X0000 00 01
100000000X	00 00X  1
1X000000	X000000N0X1
10000000	0000X 0X0	1
10 000	0X000X0XX0 01
1 000000	 000 00X0	1
1X0000 0XX00000X0X01
100000 00 0 	00000 1
10  0000000 000 0001
100 X0000X	0 0000001
10 0	00 000X0 X0 0X1
1   000000000	0 00 1
11111111111111111111
