NO test_artifacts/valid.xpm
SO test_artifacts/valid.xpm
WE test_artifacts/valid.xpm
EA test_artifacts/valid.xpm
F 0,,0,0
C 244,176,174

11111111111111111111
100 	 0 000000000001
10000X0X000000 X0 01
10000  X0X000X0	0001
100 0 00X0  00	00001
100 00000 000000X001
100X0 00 000	0000 	1
100	0000	 0000000 01
10X00000000000		 001
100 000 00000X0000 1
1 0 XX000000000000	1
100000000X0X0X0 0001
10	0000X0000X00000 1
1X00	00 N000 0000001
100X00X000 0X0 00001
10000X0	00X00 00 001
100000X000 X00 XX001
10 00000X 	X00000	X1
100000X000000000	001
11111111111111111111
