NO test_artifacts/valid.xpm
SO test_artifacts/valid.xpm
WE test_artifacts/valid.xpm
EA test_artifacts/valid.xpm
F 223,225,18
C 254,64,233

11111111111111111111
1		00 X0000  0X0 001
1X0000XX0000000 	 01
10 00X0X0000 X 0X001
10000000000000	0	001
100000000X0000000X01
1	00000000X000 000	1
100000000X X0X00 	01
100000000	00 00 00 1
1000000 0000	0 00X01
100 0000000		00X 0 1
1 00000000000000 X01
1  000	000	000 00001
10X0	0X000000 000001
10 00000000000000 01
10000000X00X00 00X01
1X000 N000 000000001
10X00000 0 000X0 001
100 00 X 00000 X0001
11111111111111111111
