NO test_artifacts/valid.xpm
SO test_artifacts/valid.xpm
WE test_artifacts/valid.xpm
EA test_artifacts/valid.xpm
F 104,53,137
C 242,79,179

11111111111111111111
10000001000001101101
10100000100000100101
11010010000100001001
10000100010010000001
11000000001000110001
10000000001000000011
10110000000000000001
10000000000110110011
10000N00000010000001
10110000000001000001
10101000000000000001
10100000010001000001
10000001011000000111
10100010001010110001
10000110011001000011
10010000100000000001
10100000000010010001
10100100001100010001
11111111111111111111
