NO test_artifacts/valid.xpm
SO test_artifacts/valid.xpm
WE test_artifacts/valid.xpm
EA test_artifacts/valid.xpm
F 4,4,251
C 235,183,167

11111111111111111111
10000001010000111001
10100010000001000001
10010000001001010101
11001000000000000001
10000000100N00000101
10000000000001000001
10001001000000000101
10000101101010101001
10010010100010111011
10000000000010000001
10010001110000000001
10000001000100011011
10000000011000110011
10000000001010010001
11000100001000000001
10101000000000110101
10000101000100000001
10001001010000000001
11111111111111111111
