NO test_artifacts/valid.xpm
SO test_artifacts/valid.xpm
WE test_artifacts/valid.xpm
EA test_artifacts/valid.xpm
F 86,244,31
C 48,252,32

11111111111111111111
10010000100001000011
10000011100001000001
11000101100001010101
10001000000010000001
10001000000000001001
100000100N0101000001
10000000000100010101
10101100001110100001
10000100000011010001
11100000001000000001
11000100001000100001
11000000100010100001
10000110010000000001
10000000100010001101
10011100100000000001
10010001000010010001
10011000001100000001
11000100001000010001
11111111111111111111
