NO test_artifacts/valid.xpm
SO test_artifacts/valid.xpm
WE test_artifacts/valid.xpm
EA test_artifacts/valid.xpm
F 94,93,226
C 197,104,153

11111111111111111111
1000000000 0  0XX0X1
10  00X000X000000001
10    0000000000X 01
1000XXX00000000000 1
1000000000X0 X0 00	1
10	0 0X00  000000001
1000000000000 000001
10X000000	X00 X0	001
10000000000000X00001
100000000000	0000X01
10000000000000000X01
10 0000X00000X000N01
100000000 000 000001
10000X000000 0X 	001
1 0000X00X		0X0X0001
1  000 00000X 0X 0X1
1X000000X0X0X00 0 01
10000X000000	 000001
11111111111111111111
