NO test_artifacts/valid.xpm
SO test_artifacts/valid.xpm
WE test_artifacts/valid.xpm
EA test_artifacts/valid.xpm
F 172,201,214
C 14,17,80

11111111111111111111
1000X0000000000	0001
1 000	00 	X	00X0X0X1
10 00X0  00X00000X01
100X0 000X 000000001
10 0000000000 000001
100000 0XX00000000 1
1X00 X0	0000X0000001
100X000 00000	00XX01
10000000X00000000  1
100000	X00000000 001
1X000000	0000 XXX001
1	000000X00000 00001
10 	0000X 0	000000X1
10X X0X0000	0	000X01
1000	0	000X000000X01
1000000 000000000001
100000	00X 	000N0001
1000000  0 X000000	1
11111111111111111111
