NO test_artifacts/valid.xpm
SO test_artifacts/valid.xpm
WE test_artifacts/valid.xpm
EA test_artifacts/valid.xpm
F 139,149,73
C 58,225,249

11111111111111111111
10000000000000010111
10000000010000011001
10000000010111000011
11001100000001000011
10000000000010010001
11000000000010000001
10100010000000000101
10000010000000100001
1000N000010000000011
11000000000110100001
10000000000010100001
11100001000011110001
10000010110000001001
10101110011000001001
11010000110101010001
11000000000000001001
10100001000010101001
11000000010000000001
11111111111111111111
