NO test_artifacts/valid.xpm
SO test_artifacts/valid.xpm
WE test_artifacts/valid.xpm
EA test_artifacts/valid.xpm
F 83,7,59
C 176,197,150

11111111111111111111
1X0 000000X  X0X 0	1
1X00000000000000   1
10000	000X0000  0001
1X000 0 0 	0X00000X1
10000X0   00	0000001
100	00	0	00X0000 X01
100X000	0	000X	00001
1000 000000000000 X1
100 X00 00000000	001
100X00 0	00N 0	00X01
10000 X0000 00 00001
100	000	0000000 0 01
10000X	X00X0000000 1
10000 0 000 00000X01
10000000 00XX0 00001
1X00000X000	 0000001
100 0 0000 0X0000 01
100 0000	00  0000001
11111111111111111111
