NO test_artifacts/valid.xpm
SO test_artifacts/valid.xpm
WE test_artifacts/valid.xpm
EA test_artifacts/valid.xpm
F 151,214,134
C 25,155,100

11111111111111111111
10000000001010010001
10100000010100000101
10000N01000000000101
11100000001000000001
10100000001000010011
10000100000000000001
10100010000000011001
10000101000010000011
10100000000001010001
10000000000100010001
10010000000000010001
11000001100010000001
10100000000000010001
10101000001000000001
10101001001001000101
10100100000000001001
10010010000100000001
11001000000000001001
11111111111111111111
