NO test_artifacts/valid.xpm
SO test_artifacts/valid.xpm
WE test_artifacts/valid.xpm
EA test_artifacts/valid.xpm
F 22,240,89
C 75,71,19

11111111111111111111
1  00  0	000X		 0001
10000000000000 00001
100  	 0X0X00X 00 X1
1000	0000 000 00	001
1 00 X00000  X000001
100000000000000000X1
10000000000 	0X0X001
10000000 00000000001
10000 0XX00X	 	00001
1000000X00 0 X000001
1	 000 0	0X000 000	1
100X000000 000XX00 1
1000 0X0000000 X0N01
1	0000		000X00000 01
100X000000X000000001
1000 0X00X X000000	1
1000000000 000X0	001
10000	000000X0000001
11111111111111111111
