NO test_artifacts/valid.xpm
SO test_artifacts/valid.xpm
WE test_artifacts/valid.xpm
EA test_artifacts/valid.xpm
F 169,143,34
C 197,216,10

11111111111111111111
10N0000 00000	00 001
10X0X000X00000 0X001
1 0	000000000 0000	1
1000 00 X0000 X00001
10000000  000X 000 1
1 00 0	00X000 X00001
10000	0000000000 001
100 0 00	000X 000001
1X00X000000	0 0000X1
10000	00 0	X00	0 X 1
1  00	X00X000	0X0001
10X00 00000X0X0X0001
1X0000 0X X 0	0 0001
1	0	0X0	0	0X0X00 001
1 00	00 	 0000 00 01
100  0000 000X 00001
1000X0 00		X0X000X01
1 00000	 0X00	00 001
11111111111111111111
