NO test_artifacts/valid.xpm
SO test_artifacts/valid.xpm
WE test_artifacts/valid.xpm
EA test_artifacts/valid.xpm
F 103,0,0
C 219,195,98

11111111111111111111
100		000X	0XX00 0001
1	00  00X00	00 	0001
100000000000XX0000	1
1000000000 000000 X1
1X0000X0X0000XX00X01
1000X0X 00	0000X0 01
100	  00X0000000X001
10X0000X00000000 001
1X0000 0000000000001
1 0000000	000X 00001
10 000X0 000 000	X01
10N 0000000X	0000001
100  000	0XX0X000001
100	0000 X00X00 0001
10 0000000	 0	0	0001
1000X00 	X  0000 001
10000X	00 000 0X0001
100000	X 000000000 1
11111111111111111111
