NO test_artifacts/valid.xpm
SO test_artifacts/valid.xpm
WE test_artifacts/valid.xpm
EA test_artifacts/valid.xpm
F 173,94,205
C 213,234,54

11111111111111111111
1000  00X0000	00 001
1 0000000000X0X00XX1
10	00000000XX0X000	1
10	00 	000000 0000 1
10  00X0X000000 00	1
10000X 0 0X0X000X001
1000	00000X00	0000	1
10 000000X00000X0001
1  00	 0000000XX00X1
1  00000000000000001
1000000000 000000001
1X0	000000N 00000001
1 000000X000000X0001
1X00 0000  000000001
10000000 0X0000X0X	1
10000 00000000000001
10000000000	00000001
10 00000X00000000001
11111111111111111111
