NO test_artifacts/valid.xpm
SO test_artifacts/valid.xpm
WE test_artifacts/valid.xpm
EA test_artifacts/valid.xpm
F 102,5,155
C 4,234,172

11111111111111111111
100000000 00 0 00001
1 0X	000  000		00 01
1000000 X000X 0000 1
1	000000X00000X0	001
100000000 X00N00X0	1
1000000X000X0 X 0001
10000X	00000X0 000X1
10000000000	00000001
100 00000X 00000X001
10000000X 000 000001
10000	00000	0 000	01
1000 X000	000000X001
100000X0 00000000001
10000 X00  000000 01
1000	0000 0X0 000001
1X000X0	0000X0000X01
100 0	0X0X0000	X00 1
1000000X000000 00001
11111111111111111111
