NO test_artifacts/valid.xpm
SO test_artifacts/valid.xpm
WE test_artifacts/valid.xpm
EA test_artifacts/valid.xpm
F 30,235,225
C 252,161,1

11111111111111111111
100X	0XX	00000000001
100	X000000	X00 0001
100 00X0 000X0 00001
100 00X00	X000000001
10 X0000000000 00	01
100000	00000000XX001
100000	00	  00X	0001
1 00 000 000	0X00001
1 0000	0000000000001
10X0	0N00000 0000001
10000X 000X0 0X00 01
1000 X00000X000 	001
1000 0X00	00000X0001
1	 000000	0000000	01
1 00 00X0000X0000001
1000  00 0000	0X0X01
1000000 00X00X0 0X01
10	000X00		000X00001
11111111111111111111
