NO test_artifacts/valid.xpm
SO test_artifacts/valid.xpm
WE test_artifacts/valid.xpm
EA test_artifacts/valid.xpm
F 0,12,208
C 216,177,200

11111111111111111111
1	 0	000000X		000001
1000 000000000000X01
100 	X0	00000	000001
1X00000	000	00 00001
100000X00X00 0000001
10000X00000000X0 001
1	0	 X	0000 000 0001
100X000X 0X00 00 0 1
10000000000000000001
10000000000	00000001
10000X 	0 	000000001
1 0 00 X00000	0000	1
1	000000000000000N 1
10X00X00000 00		 001
1 000	000000000000X1
10 00000	00000000001
10000	0  X0 00000X01
1000 X0 000		0000001
11111111111111111111
