NO test_artifacts/valid.xpm
SO test_artifacts/valid.xpm
WE test_artifacts/valid.xpm
EA test_artifacts/valid.xpm
F 35,20,236
C 206,99,134

11111111111111111111
1000 00X0000X0000  1
1000	000	X00 0	0 001
100X0 	000	0 0 00001
10 X0	00	0  00000001
10000X0X	X0	0000X  1
100 0000 000X00X0001
1000000X0000000	X001
1000 000 0X000000001
10X	0000X0	00	0X0001
1000000N00 0000000X1
1	000000 0  00 00001
1  00000000 X	 		0X1
100000 00000000 00X1
1X 00000 000	0000001
10	 XX00X0X00	000001
1  	00XX000 00000001
1000X 0 00000XX00 01
100000000X0000000 01
11111111111111111111
