NO test_artifacts/valid.xpm
SO test_artifacts/valid.xpm
WE test_artifacts/valid.xpm
EA test_artifacts/valid.xpm
F 160,168,182
C 181,50,198

11111111111111111111
10000000000111001011
11000010010000000101
10000000000100110001
10000000111000010011
10000001000100000001
10000100000101001001
11100000000001000001
110000N0001000000001
10000000000000010001
10000000000001000001
10101000001000000011
11001000000000000111
10001100100000001001
11000000001010000001
10000000001100000001
10000100010000000011
10000100000100001001
10000100001010010001
11111111111111111111
