NO test_artifacts/valid.xpm
SO test_artifacts/valid.xpm
WE test_artifacts/valid.xpm
EA test_artifacts/valid.xpm
F 162,208,125
C 84,159,132

11111111111111111111
10000101001111100101
10100010000010000001
10000000000000001111
10001000010001000001
10010001000100001001
10010000001000000001
10100110100110001001
10000010000101001011
10010000110000011101
10101000000000000001
1000010000010N010011
10000000000000000001
10000000000001001011
10000100000010001011
11101100000010000001
10001100100110000001
10000000101000001001
10000100000010010101
11111111111111111111
