NO test_artifacts/valid.xpm
SO test_artifacts/valid.xpm
WE test_artifacts/valid.xpm
EA test_artifacts/valid.xpm
F 188,,0,0
C 74,236,86

11111111111111111111
1000 X0X00000 0X00 1
10X0	 X 	00000000X01
10	00000X00000000001
10	000000X00 0000001
100X0	00000000000001
1 	000 0	0000N0000	1
10 0000000 0000000X1
1 00000 0000X0	00001
100000	0000 X0000001
10000X0X0 00000000 1
100	0X0X0X0XX	000001
1 00000 00000 0X0001
100000000000000 0001
1 00X0000 0	0X000001
100000 00000000X0XX1
1000X00 00000XX00	01
10000	000000000 0001
1 0000	00000X0000001
11111111111111111111
