NO test_artifacts/valid.xpm
SO test_artifacts/valid.xpm
WE test_artifacts/valid.xpm
EA test_artifacts/valid.xpm
F 75,0,0
C 77,152,236

11111111111111111111
100000 000000X0 X001
1X00X00X00000000 0X1
10000000000X 0 00 01
10 X 0000000000000	1
10 0000X000000X0	001
10000 00 000000	0001
100000 00000X 0 00 1
1	0000 0000 000XXX	1
10000 0X0X XX  0X0X1
10000000000X0X 00001
1X000000000	000X00 1
100 00		0000X00 0 01
1000X0	000000X	 0	01
1X0000000XX0000XN001
100X0000	00XX0000XX1
10 000000X0000000001
10X00000000000 000X1
1 00X00 0000	0X 	001
11111111111111111111
