NO test_artifacts/valid.xpm
SO test_artifacts/valid.xpm
WE test_artifacts/valid.xpm
EA test_artifacts/valid.xpm
F 120,171,83
C 147,29,114

11111111111111111111
10	0	0X0000	0000 	01
1	00 0 000N0XX000X	1
1X0 000000XX000X0001
10X00000 0000	X000 1
10 000X000000 000001
1000	X000	0000000X01
1	00 00	0000000 0001
100  	0000XX00	 	001
10XX	000X000 00X	X 1
1000 0000X00 0X00	01
1000 XX00000X0000001
1 X0 0 00000X0 	0X 1
1X 0	XX0000  000X0X1
1000 000X0	0X0000 01
100 0000 00000X0		01
1X 0000 000X0000	001
1000X000 X00000X0001
10 00X0000X00	00  X1
11111111111111111111
