NO test_artifacts/valid.xpm
SO test_artifacts/valid.xpm
WE test_artifacts/valid.xpm
EA test_artifacts/valid.xpm
F 228,200,245
C 180,235,11

11111111111111111111
10010000000101000001
10000000000000000001
10000011000101000101
10101001011001000001
10000001001000000001
10000001100000100001
10000100000000001001
10000001000001110101
10000000100010000011
10100000000010000001
10000000001101011001
10000000000110000001
10000010000000000001
110000011000N0001001
11000000010000000001
10001000010010010001
10001000000100001001
11000000000000000001
11111111111111111111
