NO test_artifacts/valid.xpm
SO test_artifacts/valid.xpm
WE test_artifacts/valid.xpm
EA test_artifacts/valid.xpm
F 198,,0,0
C 74,144,4

11111111111111111111
100000	000	00X00X001
10 00000 000000 0001
10000000	 0	X0000001
1000000000000X 00001
1000000 000000000 01
10 00X000000X 0X0001
10XX0 00000000	000 1
1000XX00	0  00000001
100000000 00	0	 0001
10	X00X00000X0000001
1000000000X 000000 1
1000000X XX 	 0 00 1
10X000000000 0XX0001
1X	N0	XX00 0000000	1
10000XX 000  XX00 01
1000  0 000000 00001
1	0 0X00000XX00X0001
10 0X		0000000 	X001
11111111111111111111
