NO test_artifacts/valid.xpm
SO test_artifacts/valid.xpm
WE test_artifacts/valid.xpm
EA test_artifacts/valid.xpm
F 66,88,22
C 164,203,19

11111111111111111111
100 00000000X00 0 01
1X0X00000 X0X 000 01
10000 00000 0XXXX001
10 0 0000	0 0X0 0 X1
1000X00000 0 0000001
100000  00000000X001
10XN00X00000000X0 01
1X00000 X00000	000 1
100000	 00	X0 000001
10000	000000	0000001
10000000000000 00001
10X 0000000000000001
100000000000X	000001
1000  000 00X XX0XX1
1	000X0  00000X	0001
1000000XX0	000X0 001
100 0X00000000000001
1 00000 000000000XX1
11111111111111111111
