NO test_artifacts/valid.xpm
SO test_artifacts/valid.xpm
WE test_artifacts/valid.xpm
EA test_artifacts/valid.xpm
F 88,71,2
C 244,140,162

11111111111111111111
1X00000X	00  000X001
1X000X000	00X0000001
1 0N00000	00X0X00001
1000X0000	000000X001
1000X000	00 0 000001
1	000 000000000 0001
10000 0000000000X001
10000X0 0X0000X0 001
10000000 	0000000001
100X00 000X000 00001
1X  X0 X0 00X0000001
1 000000	000	0000001
10X0000X00000	  0	01
100000000 000  XX001
100 0000X0000 00X	01
100		0 X0  000000001
1X0X0	 000000X000001
1 0X0000000 00000001
11111111111111111111
