NO test_artifacts/valid.xpm
SO test_artifacts/valid.xpm
WE test_artifacts/valid.xpm
EA test_artifacts/valid.xpm
F 169,19,230
C 80,128,165

11111111111111111111
10	00X00	 0	00000001
100000000 000000  	1
100000X 000000000X01
10XX0 00	00X0000	001
1	  0X000X	00000X001
1	00	00 0	000XX00001
100000000000000 0001
10000X00000	00X0 001
10X0X0X0000	00000001
10000000000000000001
1000 0 00000XX000001
10000000  X000000 01
10000000	0	0 00 0001
1000X000000X000XX0X1
10XX 0 X000000	00001
10 0 00000  0000 001
1	00X000X0N0000X0 01
1000000000000000	001
11111111111111111111
