NO test_artifacts/valid.xpm
SO test_artifacts/valid.xpm
WE test_artifacts/valid.xpm
EA test_artifacts/valid.xpm
F 160,103,32
C 100,132,37

11111111111111111111
1 000  000000 00 0	1
1X00X000 0	00000X0X1
10000 00 X0X 000 001
10	000X00	0000000X01
1	00 00000000X0000 1
100000 000X  0 00001
10 000X0X0000	000001
10X000X000000000	001
100000000000 00X0XX1
100 00X0000000000XX1
10X000000	000X00	 X1
100000X000XX  0X0001
1000 0 0	000000X0001
100  00X00X000X00 01
1	 000000  00000N001
10000X	0 0 	00000 01
10X0000 	0X00X00XX01
1000X000 0000000 001
11111111111111111111
