NO test_artifacts/valid.xpm
SO test_artifacts/valid.xpm
WE test_artifacts/valid.xpm
EA test_artifacts/valid.xpm
F 65,,0,0
C 150,215,114

11111111111111111111
1 0 000XX00000000001
1X0 X000 00000 0 0 1
1000X0X0 00000  0001
10000  0000000000X01
100000X00000000	0X01
1000	000 00 0000 	01
1X0X00X000000  0 001
10000000N000000X00 1
10000X 0X0000	000XX1
1000 0 000000 	000 1
1 0000000000 0000001
1 00000	00	00000	001
100X00  0	0000000001
10X00000000 0 000 01
1 0	000000 000	0	001
1X000 0000 000 00001
10X00X0000 0 X0	0001
10XX00000X0XX0000001
11111111111111111111
