NO test_artifacts/valid.xpm
SO test_artifacts/valid.xpm
WE test_artifacts/valid.xpm
EA test_artifacts/valid.xpm
F 41,33,35
C 15,252,63

11111111111111111111
1X00X000000X0 0	0 N1
10 		0XX00X0000000	1
10	00000X0000  000X1
10 0000 0000X00000X1
1000X000 00  X00 0X1
1 000  0000000000 01
1000 00 X	00000000X1
100	0XX00X000 000 01
1	X 000X00000 X00X 1
100X000 00X00000 001
100 X00	00000	00X0	1
1X	00 00X000000000X1
1 0000 0 0XX X00X 01
1000	000 0 00  00001
10X000000000	00X0001
1X000 0X00	00	000001
1000 00  	000 0   01
1000000000	000 X0001
11111111111111111111
