NO test_artifacts/valid.xpm
SO test_artifacts/valid.xpm
WE test_artifacts/valid.xpm
EA test_artifacts/valid.xpm
F 64,72,0
C 85,24,34

11111111111111111111
1X00X00XX0 000X00001
100X0	00	000X00 0X01
1		00X0 000 00XN00X1
1X0 00000000 0	00001
10	0000000X 00X00001
100 00000 0000000001
10000 	0000000	00001
10000000X000000	 001
1000 0000000X0000X01
100000000000 0X0XX01
100X X00000000000 01
1000 000000000000 01
1X0000000  000X	0001
1000 00  000  0000	1
100X000X0X0000 X0 01
1  00000 X0	0	0X	X01
1000 00X	00 	 000001
1 00X000000X00 00001
11111111111111111111
