NO test_artifacts/valid.xpm
SO test_artifacts/valid.xpm
WE test_artifacts/valid.xpm
EA test_artifacts/valid.xpm
F 28,0,0
C 255,121,1

11111111111111111111
1 0  000X000 X0X0001
10 00XX00 X00X000001
100000000X 000 00001
10X000X0X000000 0001
10XX	000 00000X00001
1 0X00XX000000	0X0X1
100	000000000 X 00X1
1X0000000000000X0X01
1 00XX000000X00 0X 1
1X0000X0X00	0X000001
1 00	0000	0000000001
10000000	00X00000001
1X 0000000	0000N00 1
10000	0X00000 0	0  1
10X0000		00000000001
100 X0 0000		00 0X01
1X000X	0000000000 01
1 00000000 0X0X	0001
11111111111111111111
