NO test_artifacts/valid.xpm
SO test_artifacts/valid.xpm
WE test_artifacts/valid.xpm
EA test_artifacts/valid.xpm
F 140,182,91
C 163,194,85

11111111111111111111
11000001000011010001
10000100100001000001
10000100100010101001
1010000000N000100011
11000000100010001001
11001100001100000001
10000000101000000001
11001100001011010001
10000000000000100011
11000010000001101001
10000000000101100001
10001000001000000101
10001010000000010001
11000100000011000001
10010000000001010101
10000001001000101011
10000000001000100011
10000000001101000001
11111111111111111111
