NO test_artifacts/valid.xpm
SO test_artifacts/valid.xpm
WE test_artifacts/valid.xpm
EA test_artifacts/valid.xpm
F 195,24,65
C 234,206,140

11111111111111111111
10000000000000000001
100X000 X0 0  X 0001
100X0000	0000X000001
1	0000X00X0X00X00001
10X00X00000000000X01
1000000X 000X0X00001
100X0X 000X	X00NX001
1X0000000 X0 000 0X1
10000000  0X 0X00001
10X00 00000X0X0000	1
100000000X00X  00001
1000000000 0000X0001
100000000X00X0000001
10X00 000 00000000X1
10XX 00000000 000001
1X 000X0000000	X0001
1000XX0	00000000	X01
1000000XX	000 0X00 1
11111111111111111111
