NO test_artifacts/valid.xpm
SO test_artifacts/valid.xpm
WE test_artifacts/valid.xpm
EA test_artifacts/valid.xpm
F 165,98,212
C 101,152,33

11111111111111111111
1X0 000000000 000001
1 0000X000000X0 0001
100000  00X	0	00X  1
1 00 0XX000 00 00001
10X000X X  000X00001
100X0 00000X00000001
1	X00000000 00000001
1000X0000	0000000001
1000 0 00X000  000X1
1000 0000000000 X001
1X0	X0X00	X000000001
1X0 00X0 00 00000 01
10000 N000	0X0000 01
100X	 0X000X 0000001
10000 X00000 0 000 1
1XX 0000X000 0000001
100X 0000 000XX00001
1 00000 00 0000 0001
11111111111111111111
