NO test_artifacts/valid.xpm
SO test_artifacts/valid.xpm
WE test_artifacts/valid.xpm
EA test_artifacts/valid.xpm
F 88,82,108
C 83,98,239

11111111111111111111
10X00		00000X0X0X 01
1 00 X00 0 00X00	001
100 0X000 0X00 00001
10000000000000000001
100000000000	0 00 01
100XX000000000X 	001
1000000X000000000  1
1 000000000000X0  01
1000000X000	00000XX1
10X000X00 0000000 X1
10 0000000000000 0X1
1 0000000	X00000 X01
10 000 000000X 00001
10 X0 000000  0X0  1
1X0  0000000N00X0 01
1000X0 00 0000X00001
1000X000000000000001
1 X 000000000X000X01
11111111111111111111
