NO test_artifacts/valid.xpm
SO test_artifacts/valid.xpm
WE test_artifacts/valid.xpm
EA test_artifacts/valid.xpm
F 88,132,202
C 55,178,214

11111111111111111111
10010001000000000001
10100010100000000001
10011000010000000011
100000100100000N0001
11000100100000000001
10001001010001000011
11000001000000010011
10000000000000000111
11010000000000001001
10001001000100001001
10001000100100000111
10000000000100010001
11001000011000000001
10000010000000001001
10000000000000000011
10000000000001010001
10000001110000001101
10000000111000001001
11111111111111111111
