NO test_artifacts/valid.xpm
SO test_artifacts/valid.xpm
WE test_artifacts/valid.xpm
EA test_artifacts/valid.xpm
F 35,54,226
C 154,1,139

11111111111111111111
10000X000000X0 00001
10000000000000 000 1
10000 000X0000X00001
10XX X0000 000000001
1X00000000000 0	0001
100 0000	0 000000001
1000000X0  	0	0 0001
1N000000000X00	000	1
10000X  00000000 001
10 000 000 0000	0X01
100X	00X00000X0  X01
100000000X00 000X0 1
100 0X0 00X00  XX0 1
10000000000000 000	1
1000000X000	000XXXX1
1 0 00000	000000X0X1
10 X	00  00XX00 0001
100000000 X000000001
11111111111111111111
