NO test_artifacts/valid.xpm
SO test_artifacts/valid.xpm
WE test_artifacts/valid.xpm
EA test_artifacts/valid.xpm
F 85,55,42
C 71,48,232

11111111111111111111
10 00000 00000000001
1000000N0	000X0X 	X1
100 00	X0X0000000001
1000X000 00X000000X1
1X0	000000000X000X01
10000000 X 0000000 1
1XX0000000000	000001
1X X	 X000 00X000001
100000 000000 000001
100 0000000000X00001
100 000X00		 	00XX01
100	0X00X00X00000001
10 	000X000 0000  01
100 00X00000 0000001
100 00X0000000000001
1000000 0 0000000X01
100000	0000000X00X01
1000  00 000000  X01
11111111111111111111
