NO test_artifacts/valid.xpm
SO test_artifacts/valid.xpm
WE test_artifacts/valid.xpm
EA test_artifacts/valid.xpm
F 89,112,157
C 50,56,165

11111111111111111111
10110010001100000001
10000000000010000001
10000000010010001011
11100101010010000001
10000010011010000011
10N00101000000001001
10000110000111000111
10000001000001010001
10000100000000000101
10000000100000000101
10010000000000100001
10111000100000000001
10000100000000100001
11000000000011100111
10100000100000000001
10001000000000101001
10001001000000010001
11000100000001000001
11111111111111111111
