NO test_artifacts/valid.xpm
SO test_artifacts/valid.xpm
WE test_artifacts/valid.xpm
EA test_artifacts/valid.xpm
F 195,93,155
C 162,115,116

11111111111111111111
100 0X0000000000	001
10X00N0000X0 0 00001
10		 0000X00X0	00001
10X 000000000000 0X1
1000000 0 00  000001
10 X	00000X000000001
100000	000 0	0 00 01
10000000000000000001
100000	00 00000XX001
10	0000 0	0 000 0 01
100 00000 0000 000	1
100	00	0 0 0XX0X 0	1
1000X00 0 0000000X01
100000	 000000000001
100 0	00 00 0000 001
1000000000	0X00 0001
10000X00000X 0000X01
1000 000000 X00000 1
11111111111111111111
