NO test_artifacts/valid.xpm
SO test_artifacts/valid.xpm
WE test_artifacts/valid.xpm
EA test_artifacts/valid.xpm
F 137,110,240
C 105,84,14

11111111111111111111
100X0	00X0 00000	001
10	00	0000000000X001
100000	00000000X0	X1
10000X000000N0000001
1000 0 0000 X0000001
100X000X	00000000001
1 0X00000000000000X1
100 0X000000000000	1
10 0X 0	0000	0 00001
1000X000	0000000X001
1000X00000X000 000 1
100 000000 0	X0	0  1
1000	00X0XX000X	00 1
100X 00000X00X0 X001
10000X0 0X0000X00001
1	0 0000   0 000X0 1
1	0000 00000	0X00	01
10X	00000000000	0 01
11111111111111111111
