NO test_artifacts/valid.xpm
SO test_artifacts/valid.xpm
WE test_artifacts/valid.xpm
EA test_artifacts/valid.xpm
F 211,,0,0
C 250,116,169

11111111111111111111
1000XX00	000000000X1
1000	0	0000X0X 00001
100000 XX 0000000001
1000000 N00 00000001
1 000	00000000 X00 1
1X000 00 X  X00	00 1
100 000 00X000	   01
100000000XXX00 0  01
10000000	00 00 X0 X1
10000 00000X 0X	0001
1 000000X0000X000X01
10X0000 0000000000	1
100000	00000000X	001
10000000X 0X00000001
10 00000000XX0  00	1
10 	00 000	000 00001
100000	 000000X0	001
100000X0000000000 01
11111111111111111111
