NO test_artifacts/valid.xpm
SO test_artifacts/valid.xpm
WE test_artifacts/valid.xpm
EA test_artifacts/valid.xpm
F 21,74,240
C 121,6,188

11111111111111111111
11001110100001100011
10000000000011010001
10101000000011100011
10100100000100011001
10000000010000101001
10000001001011000001
11000000010000000001
10000001000110000001
10000000010100000001
10000000000110000001
10011000000000000011
110000011000N0100101
10101000000000100001
10001010010000101001
10001100100100000001
10010000001010000011
10000110000000100001
10000001101000000001
11111111111111111111
