NO test_artifacts/valid.xpm
SO test_artifacts/valid.xpm
WE test_artifacts/valid.xpm
EA test_artifacts/valid.xpm
F 229,242,111
C 83,79,137

11111111111111111111
10XX0 00000 00000001
1000 00000 X0 000001
10X 000000000 00	001
100 00000XX0000 X	 1
100	X00N00 00X0	X 01
1X00	X	0000	00 0 001
10000X00000 00000001
10X0000000X000000001
100X0X000000000	 	X1
1000X 000000 0 00001
1XXX000000000	000001
100000 000	X000 0 01
100000X0 00 00000001
100000000000X	 00001
1000XX 0	0000X0000	1
1000X	00   000000X01
1X00X00X00X 0X0X 001
1000	00000	00000X001
11111111111111111111
