NO test_artifacts/valid.xpm
SO test_artifacts/valid.xpm
WE test_artifacts/valid.xpm
EA test_artifacts/valid.xpm
F 177,0,0
C 155,243,104

11111111111111111111
1 0X000000X000 00001
1 0X00X00	000 000	 1
1000X0 	00 0 0X000 1
100		 0X0000000X 001
1000X0X 000000X	0001
1000000000 X 00	0001
10000 0 0000X00000X1
1XX000000000 0000001
10000 0  00000 0	001
1X000000000	0000	001
1X0000000	0000X0	001
100 0000000X0000X001
100 00000	 00000X001
100000X00000X0 000	1
100000 000 00000 0X1
1	000000	00	X	000 01
100000X 000X0	0000X1
100000N0000000X0 001
11111111111111111111
