NO test_artifacts/valid.xpm
SO test_artifacts/valid.xpm
WE test_artifacts/valid.xpm
EA test_artifacts/valid.xpm
F 166,113,191
C 180,19,88

11111111111111111111
10XX00	00000000X0XX1
1X0	X00X00 00000	 01
10000 000 X00	000 01
1000000X00	0X	 000X1
100X0 0000 00 0 0001
10000	000	00	X 000X1
10000000 	0000000 01
10000000	00000	X0001
10 000000000000	0001
100000  0X000000		01
10000  00 0 00X0 001
100000000X00	0	00001
1 0X	00000000000 N01
10X00	00000 00	00001
100000000X 0X	000001
1X000	000000000 0001
10000000	X0000000001
1X0 00000	0000000 01
11111111111111111111
