NO test_artifacts/valid.xpm
SO test_artifacts/valid.xpm
WE test_artifacts/valid.xpm
EA test_artifacts/valid.xpm
F 18,80,92
C 126,131,205

11111111111111111111
10 0XX000X00000XX0 1
1X00  0X000000X00001
1X0000 0  0 00000001
1000X00 0000 0000001
10	00 00	00 00000001
100000000 X0000X0001
10000 0000000 00X001
10X0 000000 0	00X001
100000000 00 0000001
1		000 	0 000X00X001
100000000000000 00 1
10000	00X0000	00 001
1000000XNXX000000001
1X0 X00000	00XX00001
100 000000 0X0 			01
1 000	000	0  0X00001
100000X 0 XX00000	01
100000000 0000000X01
11111111111111111111
