NO test_artifacts/valid.xpm
SO test_artifacts/valid.xpm
WE test_artifacts/valid.xpm
EA test_artifacts/valid.xpm
F 130,0,0
C 103,19,85

11111111111111111111
100 0 X000 00000 001
100000  	00000000001
10000 0000	0000X0001
10 X000000 00	0000 1
1 0000XXX00000000 01
1 0X 00	X000000X00X1
100 00000X00 0000001
10000000000X0XX00001
10000000000 00000001
1X00000000 0X00000 1
100000000 X00 00	001
1 0000000  00 000001
1000000 X00000000X 1
1 000X0000X0000000	1
1000X 000 00000N0001
1000000000	000000001
100	00X0X 0000	 0		1
10000000000	X0000 01
11111111111111111111
