NO test_artifacts/valid.xpm
SO test_artifacts/valid.xpm
WE test_artifacts/valid.xpm
EA test_artifacts/valid.xpm
F 29,34,198
C 139,50,187

11111111111111111111
1 000X0000000000	0X1
1000000000	X0000 0	1
10X0 0	000000XXX0001
1 0000X0	000 0000001
10X00X0000	000X0	0 1
10000000	0  0XX	0	01
1X000 X0000	0000 001
100XX 0 000000000001
1000000XX0X 0 000X01
100 000000000X000001
100N0 0 00X0000 0X	1
10  0 00 000 00	0X01
10X0X000X00 00	 0	01
10000000000000 00X01
1 000000000000000001
10X00X0000	XX 000001
1	0XX0X000000 0	0 X1
1 0000		000 0000X001
11111111111111111111
