NO test_artifacts/valid.xpm
SO test_artifacts/valid.xpm
WE test_artifacts/valid.xpm
EA test_artifacts/valid.xpm
F 34,244,204
C 46,79,167

11111111111111111111
1	0 000	00	0X0000001
1 00X0	0000	0000X0	1
1	0X0 00000	00X000 1
1000000X000	X0X0X001
100000 00000000XX 01
100 X0000000X0000001
10000000000XX00X0001
1000X0000 000X000001
1 0X0000000000XX0001
1X0000000X000X000001
10 0000000000 	000X1
100XX0000XXX0  00001
100 0 00000X 0 00001
1000X00	000	00000	 1
10000000000 0	00X001
10 000X00N000	000001
100000X00 000 000 01
100 X000 000 00X0001
11111111111111111111
