NO test_artifacts/valid.xpm
SO test_artifacts/valid.xpm
WE test_artifacts/valid.xpm
EA test_artifacts/valid.xpm
F 272,0,0
C 228,41,23

11111111111111111111
100000000 X0000000X1
1000 X 000000	0000	1
10 0000 0000X0 000	1
100000000X00X0000001
1000 00 0X 	00000001
1	0000000 000000X001
100X00X 00000X000001
1	0000000 0000X 00 1
100X0000 000X	000 01
1	0 000000 X0X0 0X 1
10	0000X00000X0X	XX1
100000	00000X00000 1
1000000X0 0X00000001
1000000000 X00000001
1X00000000000X 00001
10000 00000000 X  01
10000000000 X 00N001
100000 000XX00X000 1
11111111111111111111
