NO test_artifacts/valid.xpm
SO test_artifacts/valid.xpm
WE test_artifacts/valid.xpm
EA test_artifacts/valid.xpm
F 6,37,224
C 117,137,14

11111111111111111111
10010000000000011101
10000000000010000011
10010000001010000001
10001000011100000001
11000000001111000111
10011100000000000011
100000010N0000100001
10100100000001000101
10000100001100000101
10010000000001000101
10000000001000000001
10001000100001001001
11010001100001000001
10000001010010100001
10010001111000010001
10010000010000000001
11001001000000000101
10010001000011000001
11111111111111111111
