NO test_artifacts/valid.xpm
SO test_artifacts/valid.xpm
WE test_artifacts/valid.xpm
EA test_artifacts/valid.xpm
F 82,63,25
C 45,47,2

11111111111111111111
1000 0X00	0000000001
10 X0X0X000 X0X00001
100XX00 00 0 00X 001
1X00000000	000 0XX01
1	000X00000000000001
1000 X00000 00 00001
1000X0000X0000	X0001
100X0000X00000000X01
100000000X000X0000 1
1000000X0 00X0000XX1
1 0	00000000 00	0 	1
10X 0 000000	0000001
10 	0000000	000X0001
100 00 00X0000	00001
1X0000	00000000X0 01
1XX0000X000000000 01
1X0 00N0X00000000 01
1X00 000X00X0 00X0 1
11111111111111111111
