NO test_artifacts/valid.xpm
SO test_artifacts/valid.xpm
WE test_artifacts/valid.xpm
EA test_artifacts/valid.xpm
F 141,13,180
C 60,77,87

11111111111111111111
10000X00X00	0000X 01
10000000 00 0X0X0001
100X0X00X000 00X0 01
10 00000 000000XX001
100000	X 00000000001
100	0000000000000001
10 X0X0000 000	00 01
1 000X	 X000 0 000 1
100 000 X00XX0000001
10000000 X00000	0001
10X000 000000 000001
1000X 0000	00N  00X1
10 00X0000 00X0 0001
10000000000000X00001
1X0X 0000000000XX001
10000 00000000	000X1
10	000000X0000000001
1X0 000	000000000001
11111111111111111111
