NO test_artifacts/valid.xpm
SO test_artifacts/valid.xpm
WE test_artifacts/valid.xpm
EA test_artifacts/valid.xpm
F 161,157,200
C 203,159,124

11111111111111111111
10101010000000001001
10000000000000000001
10000000100000000101
10000000000010101001
10000001100000000101
10000000110000000001
10011001010010110001
10000000000100000101
10110000100000000001
1000001001000N000001
10000100001000000001
10001100000010000001
10101001000000000011
11110000001100000011
11100001010100000001
10000000100000110011
11000011000011000101
10000101000000000001
11111111111111111111
