NO test_artifacts/valid.xpm
SO test_artifacts/valid.xpm
WE test_artifacts/valid.xpm
EA test_artifacts/valid.xpm
F 28,16,210
C 23,121,63

11111111111111111111
10000000000	00000001
1 0000N00000000X0X01
1000000 00X00000 X01
1X0000X	0 00X0000001
1 000X00	000	 0	X001
100000X0 0000000 001
10 000	00000 XXX 001
10000X00X	000 000001
1X000X00		0X00	00001
10 00000000 000000 1
100 00000	00X00000	1
1000		00000000000001
10000 000000XX0	0X01
1 00000000000000	  1
100  00	0X00X0000 01
10XX0	0000	0000	0001
1000000	00X 00000X01
100X 	X  000X0000001
11111111111111111111
