NO test_artifacts/valid.xpm
SO test_artifacts/valid.xpm
WE test_artifacts/valid.xpm
EA test_artifacts/valid.xpm
F 229,233,83
C 197,182,89

11111111111111111111
100X 0 000000X0	0	N1
1X00 X0XX0000X0000X1
1000000000X	X00000X1
1 00000000000000X  1
100 000X00 00X0	0001
10X0X0	00 0 	0 00	01
100  000X0	00  000X1
10	X0000000000X0	0 1
1X0X00X000 00	X	XX01
100X00X0X0000 000X01
1 00000X0 0X0000X001
1 00000X00X0 00 0001
1000X00XX0  00 00001
10000 0000X0 X 00	 1
1000X	00X000000000 1
100000000  	00000 01
10000 00000000 00001
100 0	 0	00000X00001
11111111111111111111
