NO test_artifacts/valid.xpm
SO test_artifacts/valid.xpm
WE test_artifacts/valid.xpm
EA test_artifacts/valid.xpm
F 233,96,36
C 158,243,74

11111111111111111111
100000000000XX000	01
1N0000 0X 000X000001
100X0	 00	0000 00X01
10 00X	0 0 	00000001
10X000000000  000X01
100	00000	000000 0X1
10000000  00 0000XX1
10000000X000X0 00001
10 000000000000000 1
1000 0 00X00 0000001
100			0	X0000 0000 1
100X0 0 00000 X000 1
100000 	000X 0000001
100 00000000000X0X01
1 0000X00X0000000001
100XX 00X0	00  000X1
10 X00000X0000000 01
100 0 00000X00000	X1
11111111111111111111
