NO test_artifacts/valid.xpm
SO test_artifacts/valid.xpm
WE test_artifacts/valid.xpm
EA test_artifacts/valid.xpm
F 50,170,120
C 114,197,228

11111111111111111111
10 0X 0	X0  	00X	0 1
1X0 000000000X000	01
1	 X000000000	0 0	01
1   0X0X 0	X0	000001
10	000X0 0X  00000X1
1000X0000X0 0X00X001
1000X00	0X00000	0001
1	0  000 	0 00000001
100 00000000000X0001
100 00X0X00X000	00X1
10X000000  00	X	0001
1 0 X 00000000000001
100X0000000X0 00X0 1
1000	0000	00 0  0001
1 X00X0000000 000X01
100X00X X000	0 X  01
10	0 0000 000X0000	1
1XNX00000000000	0X01
11111111111111111111
