NO test_artifacts/valid.xpm
SO test_artifacts/valid.xpm
WE test_artifacts/valid.xpm
EA test_artifacts/valid.xpm
F 105,11,172
C 8,94,240

11111111111111111111
10000000110000000001
10000000100000010001
10000000000000001011
10000001101000100011
11000000010000000001
10000000100000000101
101010100000110N0001
10000010000000000101
10101100000001000001
10000000000000110001
11000001110010000001
10000010110001000101
11001000000000101011
10000011000000000011
11010000100000000001
10000000111100000011
10001000010100000001
10000001001010001001
11111111111111111111
