NO test_artifacts/valid.xpm
SO test_artifacts/valid.xpm
WE test_artifacts/valid.xpm
EA test_artifacts/valid.xpm
F 10,231,134
C 17,10,12

11111111111111111111
1000	0000 000	0XX001
1000X0000	000	000001
1 0 000000000X000001
10X0	000000X000 00	1
100  0000000000000	1
10X0000000	X00000001
10	0	0  0000XX000 X1
10X00 00000	00000X 1
1000000000 X 00 0  1
100000	00000X0 X0  1
10	0000000X0000X00 1
1		0 00N0000000000X1
10000 0X 00000X0  01
10	 0 0000 0	0000001
100 000000000000 001
10 0X0 000000000 0 1
1X0000000000X 00 0X1
1000  X0X0 000000001
11111111111111111111
