NO test_artifacts/valid.xpm
SO test_artifacts/valid.xpm
WE test_artifacts/valid.xpm
EA test_artifacts/valid.xpm
F 22,,0,0
C 138,56,73

11111111111111111111
100000000000  000001
100X0000000   000001
1000X0000000X0X 0001
100000000 00 0  0001
1X0000X00000X0000001
1000X0000000000X0001
10	00000000000X00001
1000000	00 0000000 1
1  X000000000000X001
1000000000X00 0X0001
10 0000	0	0X00000001
1X00X	 X0X000 00	0X1
10N00000X00	00000001
10X00000	00000000 01
10X0	00000X00X000X01
10X00000000000 	0001
100 00X X00000000001
1  000	00000X0 X 001
11111111111111111111
