NO test_artifacts/valid.xpm
SO test_artifacts/valid.xpm
WE test_artifacts/valid.xpm
EA test_artifacts/valid.xpm
F 115,71,221
C 124,74,144

11111111111111111111
1 000000000X00 00001
1 0000000X0X0X000001
10000XXX00X000 	0X01
100000 0000000000001
10 X0X00  X000000X01
1 00XX	00X0000XX00X1
1 0X00	00000X0000XX1
1  0000 00000000 	01
10000X0X00000	 00 01
100	00X00000X0000001
100X0000 	0000000	01
10000000X000000000X1
10	 000000000X0000X1
10000000  N000 	X001
1 0X0000X00000000001
10 0XX0000XX000X0001
10X0X	0	0 00X00 	001
10000 00000  00X  01
11111111111111111111
