NO test_artifacts/valid.xpm
SO test_artifacts/valid.xpm
WE test_artifacts/valid.xpm
EA test_artifacts/valid.xpm
F 172,0,0
C 10,12,166

11111111111111111111
100X0XX	00000X0000X1
1X0000 00 000 0 0001
10000000 00000X00 01
100000X000000X000001
100 00000000XX00	 X1
1000X00	000000 N0001
10	0000	000 000XX001
10   X000X000 00 001
10	000000000 0 000X1
1 00000X0000000	0001
1X0X00X0X0X0 0X00 01
10000000000 000XX001
100 000X000 0X000001
100000	00X0X000	 	 1
100000XX000000000001
10000	 0X00  0 0 001
100XX0 XX0000X00XX01
10 X000 000	 00X0001
11111111111111111111
