NO test_artifacts/valid.xpm
SO test_artifacts/valid.xpm
WE test_artifacts/valid.xpm
EA test_artifacts/valid.xpm
F 41,6,89
C 28,255,36

11111111111111111111
10000  	00	000000	 1
100 00000000000 0001
10X 0000000000000 01
100	00X	XX0000000001
10000	000000000X 0 1
10 00XX00000 0X0	  1
100 00			0X0 0X00001
1000  0 0X0 0X00X	X1
1X 0000X0	0000000001
1X0	000000000X000001
1X 000X0000000000001
1000X00 00 0000 0 01
100000 0000X0000	001
1000 00 000000000001
100 00000N0000 	0001
1 00000000000X X	0 1
1000X0000	000 000001
10000		000000X000001
11111111111111111111
