NO test_artifacts/valid.xpm
SO test_artifacts/valid.xpm
WE test_artifacts/valid.xpm
EA test_artifacts/valid.xpm
F 138,209,42
C 135,23,243

11111111111111111111
1	0 0000 00000000001
10X0000	 000 0000001
10000	00000	00 0X0X1
1000X0	000000	000001
100000XX000000X00001
100X	0000000000	0 	1
1000X0000000000 0001
10N0X0000000 	X0X001
10 00 00X00000000X01
100000X0	00000000 01
10X00000 0	000000001
1000000 0	00 X000001
1 000000X00000X000 1
10000000000000	 X001
100000000000000X0001
100000000X0000000 01
1000X0000X000000XXX1
1000000 0000 	0 	0X1
11111111111111111111
