NO test_artifacts/valid.xpm
SO test_artifacts/valid.xpm
WE test_artifacts/valid.xpm
EA test_artifacts/valid.xpm
F 242,0,0
C 179,101,49

11111111111111111111
1000 X00000000	00001
1000X000000X00	0X001
100000000 0	00000001
10000X000X000 000001
1000000000000 0 0 01
1X000000000000000001
100X000000X 00000XX1
10000000X0 0X000 001
10X00	000	0000000001
100000X0000000 0 X01
100X0X0000000 0 0001
10000 X0000 X0000001
100000000000XX000001
100 0XXX0000X00X0	01
10000000X000000000N1
10000000	00000X000X1
1	 000000X000	0	0 X1
10X00000X  X0X 00001
11111111111111111111
