NO test_artifacts/valid.xpm
SO test_artifacts/valid.xpm
WE test_artifacts/valid.xpm
EA test_artifacts/valid.xpm
F 85,27,225
C 91,31,52

11111111111111111111
100	0X0X00  00000001
100000000	00X 0	  01
1000 0X0 0000	  0001
10000000  000X000 01
100 00000	X0N X000 1
1X000 0X00X0X00000X1
10 000000000000X0001
1 0000 0	0000	0		001
100 00 0000X000000	1
100000000X 00 0X0001
100X00000X0X00X X	01
1	X00	00000X000000X1
10000000X0000000 001
1 0		000000X0  000X1
10X   X00 0 00000001
10 X0000000	000X0001
100000X000	XX00  001
1 0	0000X 0X00000001
11111111111111111111
