NO test_artifacts/valid.xpm
SO test_artifacts/valid.xpm
WE test_artifacts/valid.xpm
EA test_artifacts/valid.xpm
F 181,60,115
C 165,84,232

11111111111111111111
11001001010100000001
10101000010001001101
10001100001000000011
10000000001001100001
10001100010010010011
10000000000110000011
10001010000000000001
10001101000000100011
11000000000100011001
10001000000000000111
10100000000001001001
10001010000100000001
11010000001010000001
10000000100001000011
1000N000000010000001
10000000000000000101
10001110000001101001
10000000000010000001
11111111111111111111
