NO test_artifacts/valid.xpm
SO test_artifacts/valid.xpm
WE test_artifacts/valid.xpm
EA test_artifacts/valid.xpm
F 9,182,93
C 79,114,184

11111111111111111111
100000000X0000000X01
1  0 000000000000XX1
1X00000	X000000N0001
1000000X0X00000	0001
10000 0X0X00 0000001
1X X000000000000 001
1000000	X 0 X0 00001
100000000000 	000001
10000000000X0000	 01
10000000	 0X0X0 0001
10000000000000000001
100X0000 000000	 	01
1X00000 0X0000X	0X01
1X0X0000X00 0 	00001
1 000 X0000X00000001
100000000000000 00X1
10X00000000		0000001
10000X0	X0X00X000001
11111111111111111111
