NO test_artifacts/valid.xpm
SO test_artifacts/valid.xpm
WE test_artifacts/valid.xpm
EA test_artifacts/valid.xpm
F 105,92,60
C 255,175,203

11111111111111111111
10000001001000010001
10010000000001000001
10000000111010000111
10010000011111000001
11010000100100001001
10000000000000000001
10000010000010000111
10000011000001100011
11001010000000010001
10001001011001000011
10000010100000001001
10000000000000100001
1010000000N000100001
11010000000000111001
10110000001000100001
10110010100111010101
10100000001000000001
11000001010000010001
11111111111111111111
