NO test_artifacts/valid.xpm
SO test_artifacts/valid.xpm
WE test_artifacts/valid.xpm
EA test_artifacts/valid.xpm
F 118,51,226
C 22,169,20

11111111111111111111
10001000000010110001
10000100010000000101
10010001000000000011
10000010100000010101
10000100110000000001
11011100100100000001
10000011000100010001
1100N000010001000001
11100000000011001111
11000000000000100001
10000100010010001001
10001000000001001001
11100000001001001111
11000000000110111101
10000000001000000001
10100101010000010001
10001000000100010001
10000001001001000101
11111111111111111111
