NO test_artifacts/valid.xpm
SO test_artifacts/valid.xpm
WE test_artifacts/valid.xpm
EA test_artifacts/valid.xpm
F 180,5,21
C 235,36,20

11111111111111111111
10000X 000XX000X0001
1X0000000	00	0000001
10	00	00000N0000 0	1
10000000   000  0001
1 000X00 00000 00001
1 0000	00  000X00001
1000X000X0XX0000X	01
1 00 000000X00000001
10	 X000000 00000001
100XX0000000000000 1
1X0000X000X0X000	X01
100X000000	0000  001
10000X0XXX	00X0X 001
10000000000 00 000X1
1	00	0X00X000000 001
10000000 0X000X00001
1000000X0  000000001
1000000000000	000001
11111111111111111111
