NO test_artifacts/valid.xpm
SO test_artifacts/valid.xpm
WE test_artifacts/valid.xpm
EA test_artifacts/valid.xpm
F 112,,0,0
C 50,51,80

11111111111111111111
1X000 0000 0X00000 1
10X00X00	000000	0001
1 X000X0000000X000 1
1 00X000000000  X001
100	X0000000XX00X001
1000X 	000000X0000 1
10	X00X0 X00000	0001
1X0	00000	0000X000 1
1X 0X0X00000 0000 01
1000000000 0000X0	01
10X00 X000000 00 0 1
10X000 00000X000  01
10X X0 00X00000X0001
10X	00X000000X00X001
100X 0N0000000000 01
10000	000	0000000001
1 000X000	0X 0000XX1
10 0000X000 0 00X001
11111111111111111111
