NO test_artifacts/valid.xpm
SO test_artifacts/valid.xpm
WE test_artifacts/valid.xpm
EA test_artifacts/valid.xpm
F 151,60,54
C 47,23,78

11111111111111111111
10010000000101011101
10010000000000100101
10110000000100000001
10000111010100000001
10100000100000000001
10000000100001010011
10000001000010001001
100000010N0100000001
10110000000000000001
10000000001000000001
10000000000000100101
10010001000001100001
10000000000000000001
10100010000000000001
11100001010100000001
10001011100100010001
10100110100000111001
10000000100000000011
11111111111111111111
