NO test_artifacts/valid.xpm
SO test_artifacts/valid.xpm
WE test_artifacts/valid.xpm
EA test_artifacts/valid.xpm
F 58,121,1
C 254,139,192

11111111111111111111
100000 0	000000  0X1
10 0XX	 00000 000001
100000000X000X0	00 1
10 0000	0000X00X00	1
1000  00000000X000 1
1X00 0 00 000X0 0X01
100000	0000X000 	X01
100 X0000X00000000X1
10000000X 0000000001
10  X0X0X0X000000X01
10 0X0 	0	0 0X000001
1000 000	00 00000XX1
100000	0000X00000001
10000X000X0000000001
10000000000 00X00001
10 0000 0000	 	000 1
100	0 0	000000000	01
10 XX 0N0X000X000001
11111111111111111111
