NO test_artifacts/valid.xpm
SO test_artifacts/valid.xpm
WE test_artifacts/valid.xpm
EA test_artifacts/valid.xpm
F 75,107,126
C 213,235,69

11111111111111111111
1000000000000 000001
100000000 000000X0X1
1000  00X0 0 00000	1
10	X	XX00000 X000 01
10000X00XX0000 00001
10000000000000	 XX01
10 	0000000 00000001
1X000 	 000 0X000  1
10	000 000 00000X001
100X 0 00	000000	001
1000000	0X00000	0	01
100X0 000000  0 00X1
1000X00X000000  0001
10X000X0000000 00X01
1N000000000X0 000001
1X0000000000000 00 1
100000	00X  00 00001
10000000	0000X000001
11111111111111111111
