NO test_artifacts/valid.xpm
SO test_artifacts/valid.xpm
WE test_artifacts/valid.xpm
EA test_artifacts/valid.xpm
F 33,247,11
C 118,199,206

11111111111111111111
10010000100000000101
10001000000000010111
10000100001100001011
11000010001110100011
10000000000000100011
10000000000001011101
10000100010100000001
10000000001010010001
10110001010000000101
11000000010000000011
11100101000000000001
10100110000001000001
10000100000000001001
1010010N000000010001
11010000011001010001
10100000000110010001
10000010000000100001
10010100101000100001
11111111111111111111
