NO test_artifacts/valid.xpm
SO test_artifacts/valid.xpm
WE test_artifacts/valid.xpm
EA test_artifacts/valid.xpm
F 189,207,55
C 109,126,152

11111111111111111111
1000 X000000X	000001
1000000 00 0	 00 001
10 0 00000 X00X0 001
10000X0  00X00	 0	X1
1 0 00X00000000X 001
100000 0000X00 00	01
100000X00N0000	0 001
10000	000000 0000001
10 0X0000X	00000	001
10 00000 0 00XX0	001
1	0X0 0 X		00	0 00	1
10X0X0000	00X00000 1
10 00000000000X0	001
1000000X0000000XX001
10 00	0X00 	000000X1
1000X000 000000000 1
100000000000000 00X1
100000000 00000 0001
11111111111111111111
