NO test_artifacts/valid.xpm
SO test_artifacts/valid.xpm
WE test_artifacts/valid.xpm
EA test_artifacts/valid.xpm
F 47,33,17
C 108,177,208

11111111111111111111
10X0000000 00X000001
1 00	0000X00000 0001
1000		000000X0000001
1000000000	000X 00 1
100N0 000000 000X	01
10XX000	0	000X 	X  1
1000X000	0000	0X0001
1000X0 0 00  000  01
10 0 000 XX0000X 0X1
10	0000	0 00 0000001
1000000XX0  X 000001
1	00000X0000000X0001
100 	000000000000001
100000	000X	000	X001
100 0	000000 0000XX1
100X0000X0	 000X0001
10000000	00000000001
1XXX0X0000X0000 0001
11111111111111111111
