NO test_artifacts/valid.xpm
SO test_artifacts/valid.xpm
WE test_artifacts/valid.xpm
EA test_artifacts/valid.xpm
F 61,220,215
C 221,115,212

11111111111111111111
10000000000010011001
11000000010000000011
10000010110010000011
11001000100000101001
10000000010000010111
10010000110000010001
10001000000100000001
10001100000101100001
10000001000001000001
10N00000001000100001
10000100000000100001
10100000101000000101
10010000010000000001
10000000010000010001
10000011000010000011
11000000000000000001
10000000000000000001
10000000000000000001
11111111111111111111
