NO test_artifacts/valid.xpm
SO test_artifacts/valid.xpm
WE test_artifacts/valid.xpm
EA test_artifacts/valid.xpm
F 225,125,31
C 135,4,136

11111111111111111111
10000X00X 00 0000001
100000 000 0000	0	01
1 00X00000X00000  01
100 00 0	X0000 00001
10000 0X0	00 0000	01
1	000000X0X000X00001
100000000 00 0000001
10000X0000X0	0	 0001
1X 00000000000 00001
10X000000X X00000	01
10X00 0	0X0000 00001
100XX0 0000X000X0001
10000000N	 X00 X00X1
100000000XX000 00001
10000000 000XX00X001
10X0 0 0000XXX 00001
10000	00000000000 01
1000000X XX 00000001
11111111111111111111
