NO test_artifacts/valid.xpm
SO test_artifacts/valid.xpm
WE test_artifacts/valid.xpm
EA test_artifacts/valid.xpm
F 43,252,218
C 78,220,138

11111111111111111111
100 00X0000 00000001
10000		0000000000001
100000N	X0X0000 X001
10000 0000XX 000 001
1X0 XX0000	000000001
1 0000X000 00000 0 1
1000000000X000000 01
1X 0 0XX0000000	00X1
100 00X0000000X000	1
100000000000 00X0X01
100XX0000000000 00	1
1X00X00000  X0 00X01
1 0X0000X00X0 00X001
100X000	0 00000000 1
1	00000XX00000000001
1000000000000X0 00	1
1 0000X000X000	00001
1X 0 X 00X0000 0 001
11111111111111111111
