NO test_artifacts/valid.xpm
SO test_artifacts/valid.xpm
WE test_artifacts/valid.xpm
EA test_artifacts/valid.xpm
F 232,0,0
C 98,117,214

11111111111111111111
1000	X0 0000 X000		1
1X00X000	00 00000001
100XX00 000000000001
100000		X0000X0000	1
100X00X00X00X00 0001
1000X0 	00X00 0X	X01
1	0	0X00000 0 0000X1
1000 0000000X0000001
1000 0000 0000 00001
10 000000000 0000N01
100000	000000X00	0X1
1 0000	0 000X0000001
10X000X 0000	0000 01
10	00000 00000000	01
1000000  00000000001
10X 0X00000X  X00001
10 000 000X00000X001
10 0X000X0000 000 X1
11111111111111111111
