NO test_artifacts/valid.xpm
SO test_artifacts/valid.xpm
WE test_artifacts/valid.xpm
EA test_artifacts/valid.xpm
F 172,0,0
C 6,241,231

11111111111111111111
1	0	0000	00000000001
100000000	0	 00 0 01
1000000000 000000	01
10 XX0000000 0  00X1
1000	00 00 00X0	0 01
10000000000000N00001
10X00000000000 00001
1X0X0 00X0000000X001
1X00000000000000		01
10000 00	00000X 00	1
100 00000X00 00	00X1
10000 000 00	0X00001
1  00 00000	00000001
10000X00X00 0	000001
10000XX 00	X00X00001
100X0000000000000001
10 0XX00 0	0X0X00001
100000000 000000X 01
11111111111111111111
