NO test_artifacts/valid.xpm
SO test_artifacts/valid.xpm
WE test_artifacts/valid.xpm
EA test_artifacts/valid.xpm
F 127,184,126
C 139,142,7

11111111111111111111
11000010010000000001
11001000001000000001
10000000100100000011
10000000001000001001
11000010001000000011
11010000011001000001
100010001000110N0001
10010000000001000001
10100000110001000001
10101000010000000101
10000010001000001001
10000010001000010001
10000000000010100101
10100000010000001011
10010000000000010001
10000000000000000101
10000000000011000001
10010000100001101001
11111111111111111111
