NO test_artifacts/valid.xpm
SO test_artifacts/valid.xpm
WE test_artifacts/valid.xpm
EA test_artifacts/valid.xpm
F 84,71,17
C 127,162,99

11111111111111111111
10100100000000010001
10010000000100000001
10000100000001000001
10000001000100010001
10000110000000011001
10000000010000110101
10000000010000010001
10000100011000000011
10010001110000101001
10001100000000000011
10000010000000010001
10001101110111000001
11000100000001000001
11000001001011000001
10100001010000000001
10000000000000010001
1000000N010000000011
10000000010010000101
11111111111111111111
