NO test_artifacts/valid.xpm
SO test_artifacts/valid.xpm
WE test_artifacts/valid.xpm
EA test_artifacts/valid.xpm
F 84,254,250
C 60,37,167

11111111111111111111
1 X0000000000X00 001
1000000000	00000	001
100 00000000X0X000	1
1X 000  0 00 0X00X01
1	00000000 X00000X01
1000 000  0X000X0001
100X0X00X0N	0000		01
100000	000 0000 00X1
1X000000 00	00 00001
100X0000000	00	X	001
1000X00X X000	X00001
100 000X00	000000 01
1X000 0000X0  000001
1 00000	 00000000001
10 X0  00 0000000 01
1 0X 000000 000	X0	1
10000	00X00000X X001
10000 00X0000000 0 1
11111111111111111111
