NO test_artifacts/valid.xpm
SO test_artifacts/valid.xpm
WE test_artifacts/valid.xpm
EA test_artifacts/valid.xpm
F 31,240,242
C 145,23,3

11111111111111111111
11101010101011000101
10000000000100001101
10N01000000001100011
10001000000000000011
10000011000110010001
10100010000000010001
10000000000000000001
10100000010001000001
10010000010100000111
11000000000000010001
10100000000100000011
10001000100001000001
11010010100010110101
10000000011000000001
11000001100000011101
10000010000010000001
10010101000010001011
10101000000110100001
11111111111111111111
