NO test_artifacts/valid.xpm
SO test_artifacts/valid.xpm
WE test_artifacts/valid.xpm
EA test_artifacts/valid.xpm
F 223,185,132
C 228,135,140

11111111111111111111
1000000X0000XXX00001
1000	0000000000000X1
1000 00 00000	000001
10000000000 000	0001
10000	00000000000001
1000	00 	000 00 0001
1000000XX00	0 000001
100X0000000	00000001
1X00000 000000	00	01
10X0000 000000 00001
1000	0000X0000X0 0 1
100000000000000 0001
1000000000 000	00 01
10000 X0N0X 0X0 0001
1X000000X00XX00 X 01
100000000000  000	01
1	 0000X0000X0000 01
10000 000000 0 000 1
11111111111111111111
