NO test_artifacts/valid.xpm
SO test_artifacts/valid.xpm
WE test_artifacts/valid.xpm
EA test_artifacts/valid.xpm
F 235,0,0
C 206,169,29

11111111111111111111
10	0000 00X0X00	0001
1000X000X0X00X000X01
1000X0000X000X000001
100 0000000X0	 X0001
1X00000 000000	00X01
100000000000 0X00001
10000000000000X	0X01
1000	0 0 0	000000001
1	00000X0X00X	000001
100000	 00XX	000 0X1
100 000000 0X	000X01
1000 0000000 000		01
1XXX0000000000000001
10X0X0000000000000 1
1 000000N0000X000	01
10000000	0  X 0 0X01
1000000000	000000001
10000000 000000	0001
11111111111111111111
