NO test_artifacts/valid.xpm
SO test_artifacts/valid.xpm
WE test_artifacts/valid.xpm
EA test_artifacts/valid.xpm
F 237,,0,0
C 245,147,6

11111111111111111111
1000 0X0	000 0X00001
10XX00X0 0000XX 	001
1	0000XX0	X00X000001
1000	0X0 0000000X0 1
1000000X00 000X	0001
1 X00X000X000000	001
10	000000X  00000001
10	 000N0X	000X00001
1000000X00000	000001
1 0000000000	X0000X1
100	00	  00 00000001
10000X0000	X0X0	00X1
1X000X000X00 0000001
1 0000X0 X0	  000  1
10000X0X00000 0X 001
10 0000X000000X0X0 1
1X00000	00  00000001
10 0000X0000	X00 0	1
11111111111111111111
