NO test_artifacts/valid.xpm
SO test_artifacts/valid.xpm
WE test_artifacts/valid.xpm
EA test_artifacts/valid.xpm
F 253,12,197
C 140,201,43

11111111111111111111
10X0X00 000000000	 1
1 XX00000 00X0000001
100000000000	0000001
10000X00X	0000X00001
10 0 00X000000000001
100000 00000N0X000	1
10X0 0000000	000X0X1
1000 00000000X0 0001
10XX0 0XX0000	000001
1X	000X0X0000X00 001
1X00000 000X00000001
10X0 0000000 	000001
1	00000000X000	 0X01
1	0 X000X 00  0 0 01
10 	000000X000000 	1
10X0000	0000 000 001
1X00000000X 000X0001
10 00	0000	0000 	001
11111111111111111111
