NO test_artifacts/valid.xpm
SO test_artifacts/valid.xpm
WE test_artifacts/valid.xpm
EA test_artifacts/valid.xpm
F 11,218,136
C 200,167,240

11111111111111111111
100 000X 000000  0X1
1000000X	X00000  X01
10X 0 0000X000	000	1
10000 0X000000000001
1	00  00	X0 0 00X001
10 X00000X 000000	01
1X000 0 00 000 X0N01
100	00X00X00000 0001
10000 	 000000	00001
100 0XX00 0000	00X 1
1000X000 0X0 0000001
100 00	 000000000001
1 X00000000000X00001
1000	X0	X000000000	1
100  	0X0000000 0001
1000000X0X0 	X0	0001
10	0X00000X 00000X01
10X000 000X 000000X1
11111111111111111111
