NO test_artifacts/valid.xpm
SO test_artifacts/valid.xpm
WE test_artifacts/valid.xpm
EA test_artifacts/valid.xpm
F 255,78,186
C 112,31,33

11111111111111111111
10000000001100000101
10000000100000010001
10000010001000000011
10101000000000000011
10010000000001100001
11100010110000010101
10010010100001000101
10000011000010100011
10010000000000000001
11000100000000000001
10100000000000001001
10001000000111000001
10000000000010100001
1010011000000100N001
10010000000000100001
10010000000001010001
10001001100101010101
10101110010000010011
11111111111111111111
