NO test_artifacts/valid.xpm
SO test_artifacts/valid.xpm
WE test_artifacts/valid.xpm
EA test_artifacts/valid.xpm
F 98,127,135
C 164,144,69

11111111111111111111
10000000101000000011
10000000000000000001
10000100001001000111
10011000000000000001
10000000000000000001
110N0001000100101001
11000001100001100001
11011100000000000101
10001010000000001001
10010000100010000001
11000000011010001001
10010000100101001011
11100000100100010001
11001000000001100001
10000000001000000101
10000101000010000001
11110000100000010001
10000000010000000001
11111111111111111111
