NO test_artifacts/valid.xpm
SO test_artifacts/valid.xpm
WE test_artifacts/valid.xpm
EA test_artifacts/valid.xpm
F 42,147,84
C 255,192,143

11111111111111111111
10000000  00X	0 0X01
1 0000 000X000000001
1 0X0 0	00000 X 00	1
1	0000000X0000000001
1	00X000000 000 0	01
1000 0 0 00  00 0001
1000X0000 0 0000  01
100X  000 	00000 001
1 0000	000X000X00	01
1X00  	00 00X0000001
100 000	00  00000001
100X0 X0000000 00001
100000000000	00000	1
1000	0000 	0X0X00001
100 000000000XXN0 01
10000	 0	 0000000001
1X0X 00 0XX000XX	 01
1000	 00X0 0X0 000 1
11111111111111111111
