NO test_artifacts/valid.xpm
SO test_artifacts/valid.xpm
WE test_artifacts/valid.xpm
EA test_artifacts/valid.xpm
F 133,,0,0
C 5,208,250

11111111111111111111
1 00000000X 00X000 1
1  0X0X000000 0 0001
1 000000	 0 0X000001
1X000 0000000000 001
100000	000X000000001
1000000XX	00000 	X01
10000000XX 00XX00001
1 	00000000 000 0001
1 000	XX0000X00	00 1
1X000 0X00000X0000	1
100000 0X0000000 001
1000 N	 0X0X00X00X01
10000 00000  0000001
100 0 000X0000XX0 01
100X00000000X0		0	01
100  00	00000X  0 01
10X00000000 000X 001
100	000 0000000000X1
11111111111111111111
