NO test_artifacts/valid.xpm
SO test_artifacts/valid.xpm
WE test_artifacts/valid.xpm
EA test_artifacts/valid.xpm
F 81,68,46
C 103,139,215

11111111111111111111
10100000010000101001
10000000010110001001
10010000000100100001
11000000000111000001
10000000001110000001
1100000N001000000001
10001100001000000001
11000111000101000001
10001010010000110001
10001000100100001001
10000000001100000111
10001000000000011001
10000000010011000001
10000000101000000101
10000000110100000111
10010000000000010001
10000000000100001001
10000000000100100001
11111111111111111111
