NO test_artifacts/valid.xpm
SO test_artifacts/valid.xpm
WE test_artifacts/valid.xpm
EA test_artifacts/valid.xpm
F 222,148,240
C 242,184,185

11111111111111111111
1000000000000000  X1
1 0000000 XX 00 0X01
10000000000X0 000001
1000 	X0	0	 X	000001
10	00000 000 0	 0001
100 000X00000X0X0X01
100000	0	0000000 0	1
1000	000XX0000 00 01
10 X00XN00	 00	 0001
1	000000 000000000X1
1X00	000000000000X	1
1X000000000 00000001
100000	X 00X00000X01
10 00000 00000000X01
1 000000000000000001
10000 000000		000001
10 0000  0X000000001
1000X00000X0000000 1
11111111111111111111
