NO test_artifacts/valid.xpm
SO test_artifacts/valid.xpm
WE test_artifacts/valid.xpm
EA test_artifacts/valid.xpm
F 82,253,85
C 221,165,197

11111111111111111111
10 0 00 0 0	00000001
10 00 X0 0X00 000001
1000000000 00 0000 1
1000X0000X0000000001
10000 	000		00000	01
100000 000	000XX0001
100  000  0X000000 1
1X 	000 0000X000		01
1000000000 0	 000001
10 0000	00000X0X0001
1X0000000 0000000001
1000	000000000000X01
1	 0000 00 0X0000001
10 00XX000	000000001
100X0 000000 0X0	X	1
1	0X 00  00000000 	1
10 000 00XN000X00001
100X000000X0 000 001
11111111111111111111
