NO test_artifacts/valid.xpm
SO test_artifacts/valid.xpm
WE test_artifacts/valid.xpm
EA test_artifacts/valid.xpm
F 81,151,102
C 31,226,62

11111111111111111111
1 00000 000000000001
10000000000000000X01
100 0000000 00000001
1			X0 0 00 X0000X01
10 00 00000X0 X 00X1
10000	0 00 000000001
100 00000 X	00000X01
1000X0	00X0		X0000X1
100 0X 00000XX000001
100XXX0X00X0000 X001
10	  00000X0 00000X1
1000000000000000X0 1
100X00000 000	0X0001
1 00000X000	00000001
100000X0X 0X000000	1
10XN00 0	0000	000 01
1 0 0XX0000	00000001
1000X00	00		0000	0 1
11111111111111111111
