NO test_artifacts/valid.xpm
SO test_artifacts/valid.xpm
WE test_artifacts/valid.xpm
EA test_artifacts/valid.xpm
F 26,207,147
C 25,202,231

11111111111111111111
10000X000 000 000001
10000000000000000X01
10	00000X000 0X000 1
1000000000	000X00001
1X000000X00X00000001
10X000000	0	00 00001
10000000000 00000001
10 00	0000	00X000001
100000000000X0 00001
1X0  X00 X0 000	X001
1 00 0000000  000001
10000	0000000X0 0001
1  0X000X0XX0	000001
10000000000000000001
10000XX0000 000000N1
1	000000000 0X000001
100000000000000	 	01
1000000	000000 	0001
11111111111111111111
