NO test_artifacts/valid.xpm
SO test_artifacts/valid.xpm
WE test_artifacts/valid.xpm
EA test_artifacts/valid.xpm
F 128,169,178
C 28,18,242

11111111111111111111
10X0 00000X00X000001
1000000000000	000001
1000X00	0	000		0X001
1 000	0000 0  X00001
100 00 X0X  0	00 0X1
100 000000 X	00 X 01
10 00X0XX0 00000X001
1000X0000000	00X00 1
1 XXX00000X000000 01
1 		X000X0 000000001
1000X 00000000	000	1
10	 000	000000000001
1000000X	000	 0 XX 1
10X000X	000	0000XX01
100000 0000		0000001
10000XN0000000000001
1 00000 00 0000X00	1
1000 000	000	00XX001
11111111111111111111
