NO test_artifacts/valid.xpm
SO test_artifacts/valid.xpm
WE test_artifacts/valid.xpm
EA test_artifacts/valid.xpm
F 167,78,89
C 55,11,76

11111111111111111111
1000 00X00X 0X0 0 01
100X 00 0	000 X	X001
1000	000 0X	000X0001
100000 00X 0000	0001
1 0000 00X0X00X00001
1000XX00000 0000XX 1
1 00000 000XX00N00X1
1000	00	000X0 000001
1000	 000	0X0 000001
100 X0000	0000 00 01
1	0X00 0000000 00001
1X0000X000X000000	01
100XXX00	0   X00 0 1
100000X0	00	X0	0X001
100	000 00000 00	001
1	000000000X0000 	01
1  X0X00X00000000001
100000X 000000000001
11111111111111111111
