NO test_artifacts/valid.xpm
SO test_artifacts/valid.xpm
WE test_artifacts/valid.xpm
EA test_artifacts/valid.xpm
F 86,18,155
C 16,247,6

11111111111111111111
1000	000000	X0000001
10000000000000000 01
1000000000000000X 	1
1	000	00X0000 0	0	01
100000000000000X00X1
100000X0X000X0	0	001
10000 X0 0 00X00N0	1
100 0000000000000001
100000000000X000X001
10  000000000	 00001
10000 0	0X0X00000001
1 00 00000X00000 001
1X00 0000 	000X00 01
1 000X 	000000 XX0	1
1XX00	0 0X00000000X1
10000000 	X0000	0		1
1000000	00000 00X001
1	00000000 000000 01
11111111111111111111
