NO test_artifacts/valid.xpm
SO test_artifacts/valid.xpm
WE test_artifacts/valid.xpm
EA test_artifacts/valid.xpm
F 171,57,91
C 33,123,105

11111111111111111111
1X000	00000000000X01
1 00X 	X 0	0X0X00001
100000000X00X0000X01
100000000000X0000001
10000X0000X0X00X0001
100000000  00000   1
10 	0XX0 0 00000	0X1
1 000	0000000X000001
1000X00 0	000X	00 01
1 00 0XX0 00000	0001
1 0 00 00X0 0     01
100	00000000 0 00001
1000 0	0X0 X00000 01
1X00 00 	00000000001
10000X0XX000 	0000 1
1000000X0X 00 0X00X1
100	0 0000X0	00000	1
1000N00000X0000000	1
11111111111111111111
