NO test_artifacts/valid.xpm
SO test_artifacts/valid.xpm
WE test_artifacts/valid.xpm
EA test_artifacts/valid.xpm
F 65,244,139
C 110,236,19

11111111111111111111
1X00000X00000XN00001
1000	0000	0000 	0XX1
1000 	0 000000000001
1000000000000X000001
100X0000000000000001
1X0X000	X000 0X0X0 1
1X00 00X0000 0000	01
1X000000 0000 0		001
1000000 00000X0 00 1
1 0000	00X 0000X0 01
100X0 0000X0X00  X 1
1000X0000 000XX00001
100 0000000000X000	1
1000X000000000 X0001
100000	00 0	X000 0X1
10000000	000000X0001
100		000X00000X00 X1
10 0000000000	000001
11111111111111111111
