NO test_artifacts/valid.xpm
SO test_artifacts/valid.xpm
WE test_artifacts/valid.xpm
EA test_artifacts/valid.xpm
F 245,220,28
C 134,48,218

11111111111111111111
1X00X0X000000	000001
1X	 	00	X 0 00 0	0X1
100000X00000	0X00001
100	000000		000X0X01
10	0	00000X0  X0X001
1000000000000 000 01
10 X	00000X00X 0   1
1000000000X00000X001
100000X0000X00X00X01
1 00000 000X00000001
1000X0N00000  000	01
10000000X000	00000	1
1XX000000 0	00000001
10 00000X0000000X001
100X00000000	000 X01
10X00000000 00XX0001
10X 	00X 00 00000X	1
1000000000 0 X0X0001
11111111111111111111
