NO test_artifacts/valid.xpm
SO test_artifacts/valid.xpm
WE test_artifacts/valid.xpm
EA test_artifacts/valid.xpm
F 113,,0,0
C 143,74,169

11111111111111111111
1000	000000	X0000001
10 0  000X0000000001
100000000000	0000001
1000X00 000 	 000X01
1 00	0 000000 X00001
10000000000000X00001
10	00 0000 000 00 01
1000000000000	0 00X1
10000 00000	00X00001
10000000X0000000  01
1X00000X000000X00001
10000000000  0000X01
1	0	000000000 0X0N01
10X00000000000  0001
1000000	00000000	0X1
10X 000	0000000 0	 1
10000X00000X00000001
10000000000X00000 01
11111111111111111111
