NO test_artifacts/valid.xpm
SO test_artifacts/valid.xpm
WE test_artifacts/valid.xpm
EA test_artifacts/valid.xpm
F 90,212,63
C 108,217,74

11111111111111111111
10000110001010100001
11000000000000000001
11100111000000000011
10010000000000000001
10101000100100000001
10010000100000000101
10100000100000000011
10100000000010001011
10000000100001000111
10100010010010100001
11000000000001000001
1000000110N000100001
11000000000000010001
10010000110000000101
10001000001100000001
10010100000010000011
10000010000001000001
10001010010000001001
11111111111111111111
