NO test_artifacts/valid.xpm
SO test_artifacts/valid.xpm
WE test_artifacts/valid.xpm
EA test_artifacts/valid.xpm
F 176,195,75
C 159,116,26

11111111111111111111
10000000N00X000 0001
1X0 00 0000000X00001
100 000X	00	00000X01
100XX000	0000  00 01
10000X0000 0000 0001
1		0  0000000000X	01
10 	00 0X000000 0001
100 000 0000X	0000X1
10	00X0 0000000 0001
1000X0X  X000000X 01
1XX00000X00000000001
100X000	00	00X0 0001
1000000000000000 001
1X0000 00XX00000XX01
100000X000	 00 0 001
10000000000X00 000X1
1	X	0	000	00	 X 00X1
10X00 00	0X00 000001
11111111111111111111
