NO test_artifacts/valid.xpm
SO test_artifacts/valid.xpm
WE test_artifacts/valid.xpm
EA test_artifacts/valid.xpm
F 194,,0,0
C 39,8,178

11111111111111111111
1000000	00		0000	 01
1X0000000000000X0X01
10000000000000 00001
1000	0X0000000 0	001
1XX000	X000 00X00001
10	000000	0000X0	001
100000000 0000000001
10	X0000X0X00 000001
1  000000000 00 0001
1000 0X0000000X00001
100		00 	 0X000 0001
1000000 000000 00X01
1X00000000000X00  	1
100X00 000 0X0 000X1
1000X00N00	X00	00001
10 0X00X00000X00X001
10000X000 0000	0 	01
10000000X0000X00X001
11111111111111111111
