NO test_artifacts/valid.xpm
SO test_artifacts/valid.xpm
WE test_artifacts/valid.xpm
EA test_artifacts/valid.xpm
F 200,226,123
C 79,248,238

11111111111111111111
11000000001000000011
10000000000001010001
10000000000000000001
10001000000100001101
11000011010100010101
10000000000010100001
11001000011001000011
10100010011000000001
10000010010000010001
10101000000000000001
11001000010010101111
100010N0011000000101
10000000000000100011
10000000110100100001
10010100000001000001
10000000010000001001
11000000010010111101
10000100000100000001
11111111111111111111
