NO test_artifacts/valid.xpm
SO test_artifacts/valid.xpm
WE test_artifacts/valid.xpm
EA test_artifacts/valid.xpm
F 128,182,94
C 6,142,164

11111111111111111111
1000 0000X0000000001
1X0000 000000 0X00 1
1000X00N0 000 	00 01
10000000000000000  1
10000000000 0X000  1
1000000	00 000000001
1 0000 00000XX00  01
10	00 00000X000 0001
1000X0  00	000X	X0X1
1  000	 0X0	0	0X0001
100000000 000X  00 1
100000X000  00000001
1X0000 0000000000001
10000000000 00000XX1
1 00XX0	00X00X00 0	1
1000000 00000 000	01
100000 00	0 000	0001
10X0000000 00 00 	01
11111111111111111111
