NO test_artifacts/valid.xpm
SO test_artifacts/valid.xpm
WE test_artifacts/valid.xpm
EA test_artifacts/valid.xpm
F 62,61,83
C 181,211,146

11111111111111111111
10000010000110101001
10001101000100001001
10000000000000100101
10010000000000010001
10000000010010000001
10N00010001001000011
10000001000000000001
10000000000010011101
10000010000000001111
10000000000010101001
10100000010011100001
11010000000000111011
10100000100100010101
10000000000000100001
10100010000000100111
10000010101000000001
10100010000001010001
10000000100000000001
11111111111111111111
