NO test_artifacts/valid.xpm
SO test_artifacts/valid.xpm
WE test_artifacts/valid.xpm
EA test_artifacts/valid.xpm
F 182,19,240
C 192,148,96

11111111111111111111
10001011110010000101
11000000001000010011
1000N000000110001001
11100000101000010001
11000010001000000101
10001000000000100001
10001100000000000001
10000101000000000001
10000100000110000001
10001100100000000001
10000100010010000001
10010000000000000001
10100010000100100001
11001001001010000001
11000000100000001001
10000010000000110011
10010011010000000101
10000010001110000001
11111111111111111111
