NO test_artifacts/valid.xpm
SO test_artifacts/valid.xpm
WE test_artifacts/valid.xpm
EA test_artifacts/valid.xpm
F 12,113,243
C 236,186,208

11111111111111111111
11000110000001001001
11000000000000001001
10001100000100010101
10000001000001000001
10000000000000001001
10001010000000000001
10001000010000100001
101100N0000100011001
10000000000000000111
10010000000000000101
10000000000000000101
10000000010000000001
10100000000001010001
10100000000100000001
10100000000000000101
10000000000000000001
10110000000110000011
10000000000000010111
11111111111111111111
