NO test_artifacts/valid.xpm
SO test_artifacts/valid.xpm
WE test_artifacts/valid.xpm
EA test_artifacts/valid.xpm
F 23,127,28
C 126,236,34

11111111111111111111
10010000000010000001
10000000000100100001
11001001000001010001
10000000000101000101
10100010100000100001
10010001001100000001
10000000000000001101
10000000001000000011
10100000000000010101
10001000000011000001
11100000000101011011
11000010000000000011
10011001000000000011
10001001001011010111
10000000000001011101
1000000000N001000001
10010010000010000101
10000000000100011101
11111111111111111111
