NO test_artifacts/valid.xpm
SO test_artifacts/valid.xpm
WE test_artifacts/valid.xpm
EA test_artifacts/valid.xpm
F 114,104,49
C 166,52,66

11111111111111111111
10010101100010000001
11000000000010000101
10001100000001100001
10000000000000100001
10100000N00010000001
10000000000000001001
10010000001000000011
10100000000000110001
11000000000000100111
10100000000000000001
10010000100010010001
10000000010001000001
10100110000000100011
10000000100101110011
10010001100110000001
10000000000000100001
10001010001000000001
10101100010100001001
11111111111111111111
