NO test_artifacts/valid.xpm
SO test_artifacts/valid.xpm
WE test_artifacts/valid.xpm
EA test_artifacts/valid.xpm
F 161,250,193
C 42,100,117

11111111111111111111
10011000000000001011
10000111001000000001
11110011010010000001
10000001100001010011
10000000000100000111
10110000000000N01101
10000110000000001011
10000000100000000001
11001000000001000001
10000000000000001011
11000111000100101001
10000000001000001001
11000000110000000001
10000000000010010101
11000001000000000101
10000000010000000101
10100101000000110001
11000000000000101011
11111111111111111111
