NO test_artifacts/valid.xpm
SO test_artifacts/valid.xpm
WE test_artifacts/valid.xpm
EA test_artifacts/valid.xpm
F 116,3,243
C 25,214,211

11111111111111111111
10 0 000000000000001
100000 X0000X0	00001
1000	0	00000 0 00001
1	0	0 0 0000000 0 	1
10X 	00000 000X00X01
1000000  00X000X0 01
1XX00000000 0X000001
1	0X0 00	0	0000 00 1
100XX 00X 00000	00 1
1000X00000000 000001
10	0	0XX0 0000 00001
100000000000000000X1
1000X0	000000000X001
100	000 0000	0X00001
1000X0X00    X000001
10000	 00000	00 	0 1
10	0X00	000000000001
10000X0000XN  000001
11111111111111111111
