NO test_artifacts/valid.xpm
SO test_artifacts/valid.xpm
WE test_artifacts/valid.xpm
EA test_artifacts/valid.xpm
F 88,243,245
C 135,29,69

11111111111111111111
10001010000010000111
10100000000011000001
10000100000001000001
10000001000000110011
10001100001001000101
10000010001000000001
10010000000010000001
10000001000101000001
10000001100000101001
10000000000000000001
11010001000000000001
10100000000000000001
1001000100N000100011
10011000000000000101
10001011001000010101
10011001101000000011
10000100010000001011
10010000000000000001
11111111111111111111
