NO test_artifacts/valid.xpm
SO test_artifacts/valid.xpm
WE test_artifacts/valid.xpm
EA test_artifacts/valid.xpm
F 58,70,244
C 253,172,109

11111111111111111111
100000	00 0 0X000001
1 0000000000	0000X01
1X0X0X 000	0000X0001
1000X0 00000000000X1
1000X 0000 000  00 1
100000X00X00000	X 01
1	0000	 00	0000X0001
10000	00  0 00000001
1X000	000 0N0	0X0001
10000	 X00000000X0 1
10000000X00000000001
10 0 X0000X0X0000001
1000 0000000X00000 1
10X00000X00	00000001
1 00000X0000X	0X 0 1
1 X000000000 X000 01
1 0000000000 0X00	01
1 		0X0 0 0 0 X00001
11111111111111111111
