NO test_artifacts/valid.xpm
SO test_artifacts/valid.xpm
WE test_artifacts/valid.xpm
EA test_artifacts/valid.xpm
F 40,42,42
C 142,95,95

11111111111111111111
1000X0000X0X0 000001
10000 X0 00	00000001
1000 XXX000000 00001
100000000000	00  001
10	00000XX00X000	001
100X	000000	000000 1
100	0000000 000X00 1
10X X00000 XX0000001
1  0000000	0X0000001
100000000X00X0 00X01
1000 0X0 XX0N0 00001
1 00 00 XX00 0000 01
1000 000000 00000001
10 000  00XXXX0X	001
100X  0	000000000 01
100	X  00 0X0 X  	 1
1 000000  000 000X01
10X00X00000 	0000	 1
11111111111111111111
