NO test_artifacts/valid.xpm
SO test_artifacts/valid.xpm
WE test_artifacts/valid.xpm
EA test_artifacts/valid.xpm
F 44,230,79
C 202,43,146

11111111111111111111
1000 0000 X 00 00001
1X0X0	0000000X0000	1
1000  000 000	000X 1
10000	00X	00000X 0 1
100  0000 N0 X0000 1
1000000	 0X0000000 1
1000 000000000000	01
100X0 000 0000000001
10X00000 000 0000 X1
10 0 000000000	00001
1000 X0XX0  00000001
10 00000000X00 00X01
10 00000X0	X00000X01
100X0  00 00 00 	001
1000X00 000000000 	1
10000X0000	000X00001
1000X00X0000X	X 0001
1000000000000	0 00	1
11111111111111111111
