NO test_artifacts/valid.xpm
SO test_artifacts/valid.xpm
WE test_artifacts/valid.xpm
EA test_artifacts/valid.xpm
F 96,205,96
C 165,251,255

11111111111111111111
10000000 0000	000001
1000X	0X 00X000000 1
1000000X00000000X0 1
10000X0000	 0XX0 001
1000X000000000 00 01
10X	0000	0	000X00001
1 X00  000 0000	0X01
10X0000000X00X0XX 01
1000 000 X0	0	000001
100000000000	00 X001
10	000000000000 X0 1
10000X0	000 X0 00001
100XX 0X 0N0000 0001
1000000000	000X 	0X1
1 00 00000X000 0X001
1X000000 00000000001
100000	0000XX	0000X1
1000000	0 0000 00XX1
11111111111111111111
