NO test_artifacts/valid.xpm
SO test_artifacts/valid.xpm
WE test_artifacts/valid.xpm
EA test_artifacts/valid.xpm
F 246,247,167
C 240,169,152

11111111111111111111
100 0 0000000  00001
1000 0000	00NX000001
10000X00000000X00001
100 X00000 000000001
1000000000000000X001
1000 X00X0 		0 00	01
1000000X 0X000 0 001
100000  00000X000001
1X 0 0000000X000X001
100  0000000 X000 01
1000000 00X000000001
100000000XX00X000001
10000 00000000000X01
10 0000 00000000	001
10 X00X000000	0 0001
1000	X000000000X00 1
10000X X0000	000X0 1
1000000000000000	001
11111111111111111111
