NO test_artifacts/valid.xpm
SO test_artifacts/valid.xpm
WE test_artifacts/valid.xpm
EA test_artifacts/valid.xpm
F 218,126,168
C 205,73,77

11111111111111111111
1X000 0 000X000000	1
100000N00000000 0 01
1000 X0 X00	00000001
10000000 0000X000001
100000	00000 0000 01
10 00000	 0 00000001
1000	000000X000 0001
10 0X00X 00 00000001
1	  0X000X00X000	001
10000000000000	 0001
10000000X00 XX00 001
10X0000X000000000001
1X00X000 	00X0 00  1
100XXX0000  0000X001
1XX00	000X00 0000001
10000X0	0	X000000001
10X0X	0X000000000001
100	X000000000X000 1
11111111111111111111
