NO test_artifacts/valid.xpm
SO test_artifacts/valid.xpm
WE test_artifacts/valid.xpm
EA test_artifacts/valid.xpm
F 200,186,59
C 42,193,178

11111111111111111111
1 000X 00000  XX	0 1
10X000000	0000 00001
1000000000N000  0 01
1X000X 00X0X	 0 X001
1  	 XX000X000X0 0 1
100000000X 000 0 X01
100000000000000 X001
1X0X0X0 0000X0 0X0 1
1X0000X	X 0000000001
1 000X 000000X00XX01
1 00X000000000X000 1
10000000000000X 00X1
1000000000X0000 0001
1	 000000X00000XX001
10000000000000X 0001
10XX 	 000 000  00X1
10000		X00000000X001
10 0X0	0000	0	0000 1
11111111111111111111
