NO test_artifacts/valid.xpm
SO test_artifacts/valid.xpm
WE test_artifacts/valid.xpm
EA test_artifacts/valid.xpm
F 267,0,0
C 20,193,146

11111111111111111111
10 0X000000000000	01
1		 00	0  0000000001
100000	0000000	00X01
10X0000000 00	0X0 01
100 0X000  	0000	0 1
1000 0 0000000000001
100X 0000000	000X001
10X	 000X X000X00001
100 00000000	0000X01
100	0000000 X X00	01
10 0000000000   0001
1XX00X0X000X00000001
1000	00XX00000000001
10000000X 00 X	000 1
10000X00000 00000001
100000000XX0000N0 01
100 X00	X000 00000X1
1000XX	00000X 00	0X1
11111111111111111111
