NO test_artifacts/valid.xpm
SO test_artifacts/valid.xpm
WE test_artifacts/valid.xpm
EA test_artifacts/valid.xpm
F 56,122,248
C 192,160,185

11111111111111111111
11000000000001011001
10000000001001000001
10000000000000000001
11000001000000000001
10000000000000000001
10000000001010000001
11000100010000000001
10000001010000110011
10000010010000110001
10100000000000000011
10000000000000010001
10100100010100000001
10010000000000000011
100000001010N0001001
11100000000000001001
10000000000100010101
10010000010000010001
10100101000010000111
11111111111111111111
