NO test_artifacts/valid.xpm
SO test_artifacts/valid.xpm
WE test_artifacts/valid.xpm
EA test_artifacts/valid.xpm
F 60,206,215
C 80,216,181

11111111111111111111
10000000010000001001
10000001011001000101
10100000000000000001
10000111101000000011
10000000011010001001
10111000000000100001
10001000000011000001
10000000011110011001
10001101000100100001
10000000000000101001
10100010001000100011
10101001000000000011
11000010000000000011
100000000100000N0101
10010100000101000001
10000000000000001001
10010100000100000001
10010000001000000001
11111111111111111111
