NO test_artifacts/valid.xpm
SO test_artifacts/valid.xpm
WE test_artifacts/valid.xpm
EA test_artifacts/valid.xpm
F 124,203,215
C 211,41,50

11111111111111111111
11000000000001010001
1001100N000000000011
10001000000001000001
10110000000000110001
10000000010101000101
10000000110000010101
11101010001011000001
10000000000001001011
10000000010010000001
10001000000010000001
10000000000011010011
10101000000000010101
10000000010000000011
10111000001001000001
11110110000000000111
10001000000000110111
10010001000010000001
10010000000001000001
11111111111111111111
