NO test_artifacts/valid.xpm
SO test_artifacts/valid.xpm
WE test_artifacts/valid.xpm
EA test_artifacts/valid.xpm
F 106,233,88
C 201,15,105

11111111111111111111
1 00XX00 00000 0	001
1 00000	00000	X00X01
1 0 0000000000000X01
1000 00000X00 0X	X01
10000	000 0 000 0 01
10000	000X00X0000001
100X000	000 0	000001
1000XX0000 00XXX0001
100 0000000000 00001
10000000X0X00000X 01
1 000 00000000XX0001
100000 0000 00000 01
1X0000 0000X000000X1
100000000000	0X00001
10X	00	0	00 00000001
10000 0XX00000000001
1NX00 	0X00  0000X01
1X0000000 0000X 0001
11111111111111111111
