NO test_artifacts/valid.xpm
SO test_artifacts/valid.xpm
WE test_artifacts/valid.xpm
EA test_artifacts/valid.xpm
F 250,143,232
C 231,14,26

11111111111111111111
10000 00	 0000X 0001
10	000000 00X0X0 0	1
1	00000000000000X 	1
1000XX0 00000000  X1
1X00000000 0000000	1
100X0 000000X00 X001
100X00 0000000000001
100000000 0000000001
10000000000X000000	1
1000000 00 0X0 0 001
1000000000 000000001
10X000X000	000 X0001
10  0XX00	00000000 1
100X0000X00 		0X0001
1X0	 000000000000 01
1	00X000000X00X00001
100  0000	N0X000	X01
100 000X00X0X000  01
11111111111111111111
