NO test_artifacts/valid.xpm
SO test_artifacts/valid.xpm
WE test_artifacts/valid.xpm
EA test_artifacts/valid.xpm
F 55,163,171
C 78,68,223

11111111111111111111
10000 00000000000 01
100X0X00	000XXX00001
1	0 0000X0000000X001
10	00	0000	000000001
1X 	000 00	0000	00X1
1X000  000X0000 0001
10X000 000000000 001
10000000000	00 0	0X1
1 000X00000 00X00001
10 0000000000 XX	001
100	00000000 00	00X1
1   0X0000000 0000X1
10 0	0X0N0	X00000001
100X00000000X000X001
10000000000	0  X0X01
1 0000XX0 00X0000001
1X000	000 00 X000001
1000X00000X0000X0001
11111111111111111111
