NO test_artifacts/valid.xpm
SO test_artifacts/valid.xpm
WE test_artifacts/valid.xpm
EA test_artifacts/valid.xpm
F 17,181,17
C 31,202,138

11111111111111111111
1000X00 000000XX0X01
10 X0000000X0 000001
1 000 00000	XX000001
100000	000000X0X0001
100000000000X	X00001
1 00000000X	0	 00001
10000 0 00000 0XX001
1X00		000000	0XX0	01
1X000000000	00000X 1
10X00 00000000000	01
1X0N00000 000 000	01
1X0 00000 0X00000001
10000X000X0000	0X001
1XX00000 00000000X	1
1000	000X0	0 0X0X001
10X00 000000X0000001
10X000000000	0	000X1
1X000000X000000X	 01
11111111111111111111
