NO test_artifacts/valid.xpm
SO test_artifacts/valid.xpm
WE test_artifacts/valid.xpm
EA test_artifacts/valid.xpm
F 214,,0,0
C 56,207,204

11111111111111111111
1000000X00 000 000X1
100 0 0000X00000	XX1
1	0	00XX00 	00000001
1000XX0XX00 000 XX01
10000000	 00000000 1
10	00X00000000XX		01
1000X00000	 X000	 01
10000X00 00000X0	001
1000 00 0X00X000 001
10	00000X00000000001
1X000X XX X0000 00 1
1000000  X000000 X01
100000 0000000X000 1
100N0000	0	0 00	0001
1000000X000	000 XXX1
1 00000 00000X0X00 1
10000 0000000000 0	1
1000000000	0000X00 1
11111111111111111111
