NO test_artifacts/valid.xpm
SO test_artifacts/valid.xpm
WE test_artifacts/valid.xpm
EA test_artifacts/valid.xpm
F 206,118,141
C 130,171,96

11111111111111111111
10X000	0000000000001
100000000000	X 	0 X1
1X00X000000 000X0001
10000000X00	00X0XX01
1000000000000000X001
100000X00XX000	 00X1
100000 00 0000000001
1000X00 	 0XX0  X  1
1 000000000 00	00001
100N 000X000X0  X0	1
100000 000000000X001
1X0XX00X00000 00XX01
100000X000 00		00001
1XX	X00X000000000  1
10000		 000 0X000001
10000X00000000000001
10 0000000000 X00X01
1000X 0000000		 0 X1
11111111111111111111
