NO test_artifacts/valid.xpm
SO test_artifacts/valid.xpm
WE test_artifacts/valid.xpm
EA test_artifacts/valid.xpm
F 164,234,28
C 207,8,87

11111111111111111111
1X  0000X00	000X0001
10XN0X000X0X00000001
1X000 0000000	000001
10X 000		X0X00 0 0X1
100000	00000X0 00001
100000000000000000	1
1 0 	00000X00000 0X1
1000	0000 00 X0X0001
100	X	000 000000	 01
1000000000	0000000X1
10	XX000	000000 00	1
1000000000X000000001
1X00	0000	0000000001
1000000 X000	X000001
1XX0000 	  X00000	01
100000X 0X000X000X01
100XX000000000000001
1	00000		00000000X01
11111111111111111111
