NO test_artifacts/valid.xpm
SO test_artifacts/valid.xpm
WE test_artifacts/valid.xpm
EA test_artifacts/valid.xpm
F 253,68,152
C 64,39,44

11111111111111111111
10000000 00 		00	001
10X00000 0X00000 XX1
1X00X00XXX00X0000001
1000 00  X00X  00001
10X000000000	0X00001
1 00X00 0000000X0001
1000000X0000 00X0 01
100000 000	X000X0 01
100 000000X	 000 001
1000  00000000XX X 1
100X0000000000000001
1N00 X00000000 00001
1000	000X00X000	 001
100X0000	00	X0X00001
1  0 000000000X 00 1
10X00 00 	 00X000001
10000000000	0X	000 1
10000X000 0000X00X01
11111111111111111111
