NO test_artifacts/valid.xpm
SO test_artifacts/valid.xpm
WE test_artifacts/valid.xpm
EA test_artifacts/valid.xpm
F 239,99,74
C 181,219,73

11111111111111111111
10X0 XX00000 0X000 1
10X0000000X 0000 	01
1X000X000000 000	001
100000X0X0 000000001
10000 0000 000X00001
1 00 00 000000	0 001
100000	X00000 000X 1
1X0000  00X 00 00X01
100000000X 00 000001
10000X 0 0 00XX0X001
100	000000 0 0000001
1X000 00XX00000000 1
1X 000000000X0000	01
10000000X000 00X0	01
1000	000XXX	0	00	001
100000 00	0000000001
1000000N00	00 00X X1
100000000X0000 00001
11111111111111111111
