NO test_artifacts/valid.xpm
SO test_artifacts/valid.xpm
WE test_artifacts/valid.xpm
EA test_artifacts/valid.xpm
F 87,140,114
C 250,227,212

11111111111111111111
10010010010000000011
10000001001000010101
10000000010000000001
10000001010010000001
11010010000100000011
10000000000010000001
10100100001000001001
10000000000001010101
10010011001011000001
10100100000000100001
10001010000001000101
10000000000100000001
10100101000001100101
10000000000100010001
10000000111100000101
10010001100000000001
10000000100100010N01
11100000000000100001
11111111111111111111
