NO test_artifacts/valid.xpm
SO test_artifacts/valid.xpm
WE test_artifacts/valid.xpm
EA test_artifacts/valid.xpm
F 38,98,8
C 12,206,166

11111111111111111111
1000X 0 00000XX0 001
10	0X0  0X0000	000X1
10X 0000 0000	000001
100000000000000 0001
1 X0	 000X	0 0 X0 01
10X0000	00000	X00001
10X0X00 000 000X0001
10	0000000 000X00001
100000X0	00000 000X1
10000X 0000XX0X00001
10	000X0	 000 0X0001
10	0 0000 00X000X001
1 0000000 0000	0 XX1
100X0X000	0X0000X001
1 000X	X00000000 0 1
10000000000N0000 001
10000000000 0000 001
100 000 X 0X00X00001
11111111111111111111
