NO test_artifacts/valid.xpm
SO test_artifacts/valid.xpm
WE test_artifacts/valid.xpm
EA test_artifacts/valid.xpm
F 222,71,137
C 146,223,62

11111111111111111111
1000000	X 00 00	0X 1
10000	 	000000000 01
100	 000 00000X0 001
10000000000	 0X00001
1X 00000000 00 00X 1
1 X0X0 0X00000X00	01
10000000X00000X0	0	1
100X000 0 XX0000 001
10000X0 X00 000000 1
100000 00	00 0X0		01
10 00000XX0000000001
1000 0X000000X000001
10 X00	0000000000	01
100X0000000 0X00		01
10000000X 0X000000 1
10X0	X0 0000 0N000 1
100X0000X 000000XX 1
10X00X0000X00000	001
11111111111111111111
