NO test_artifacts/valid.xpm
SO test_artifacts/valid.xpm
WE test_artifacts/valid.xpm
EA test_artifacts/valid.xpm
F 244,0,0
C 205,81,112

11111111111111111111
1X00  0	00000X0000X1
1000000X0XXX000 0	01
1000X00X000X00000001
1X X0 0000X00000X 01
1000000 00X00000 001
100 	 000X000		XXX01
100 0 0  X 0000X0001
1X 0 0		000000000001
10XX00000000 000X0 1
1N0 0000 00000000001
1XX000	0000000000X01
100000000 0000  X 01
10000 00X0000 000001
10 0000X000XX	000 	1
1 X000000000000000 1
1000000X000000000X 1
10000000000000000X01
1000 X000X000X000 01
11111111111111111111
