NO test_artifacts/valid.xpm
SO test_artifacts/valid.xpm
WE test_artifacts/valid.xpm
EA test_artifacts/valid.xpm
F 190,209,49
C 217,33,207

11111111111111111111
10000000000000001001
10100000000000000001
10100100000000010001
10000000100N01000101
10000000010000000101
10001000010000101001
10000000000001000001
10110011000011000001
11010000100101010001
10010000000110000001
10001100000001010001
10000000000000000001
10001000100000101101
11100000100010110001
10001000000000111011
10001000100010000011
10010001000100001101
11001000000001000001
11111111111111111111
