NO test_artifacts/valid.xpm
SO test_artifacts/valid.xpm
WE test_artifacts/valid.xpm
EA test_artifacts/valid.xpm
F 169,244,36
C 158,160,187

11111111111111111111
11000000000100000001
11100000101100000001
10001000000011000011
10000011001000011011
10100000010000000011
10000010100000001001
10000100000100101001
10100001000110000001
10000100100000000001
10000000000100100001
11001010001010010001
10001010000000100001
11000010000010001101
10000110000010001001
10N01100001000100001
10000100000001000001
10011000100101010101
10000001000000100001
11111111111111111111
