NO test_artifacts/valid.xpm
SO test_artifacts/valid.xpm
WE test_artifacts/valid.xpm
EA test_artifacts/valid.xpm
F 200,10,119
C 118,69,78

11111111111111111111
11000001100011010001
11000000000000000001
10000010101100000001
10010000010000000001
10000000000000000001
10000011110000000001
10010010000000000101
10000110000000001101
10000001000001000101
10000100001000000001
11100001000100000001
11000001000000000101
11100001000000001001
10010000000000000001
11000001000100N00001
10000000001000001001
10011000000001000001
10000001010000000011
11111111111111111111
