NO test_artifacts/valid.xpm
SO test_artifacts/valid.xpm
WE test_artifacts/valid.xpm
EA test_artifacts/valid.xpm
F 48,95,126
C 144,67,165

11111111111111111111
10100001000011000001
10011001000000000001
10000000101100001001
10000000000000000001
11000001100000001001
10110110011010001001
10000000001000100001
10101100000010010001
1001100N001000111001
11000000000101010001
10000011100000000001
11000100000100000001
10000000100001010011
10000000010000001001
10101001000001000001
10000000111000010001
10010001000010110011
11000000010100000001
11111111111111111111
