NO test_artifacts/valid.xpm
SO test_artifacts/valid.xpm
WE test_artifacts/valid.xpm
EA test_artifacts/valid.xpm
F 106,35,18
C 125,109,151

11111111111111111111
10000 0 00	0 	0X0001
1000X00XX000000000	1
1000	 0X0000 0000 01
100X000X00000000 X01
1 0	0X00 0000000	X01
10 	0000000 00000	X1
1000000X000000000001
10XX000000	000XX 001
10000 N000 00000 	01
1  00000000000X 0001
10000	000	000X000001
10X 0 000000000000 1
10	0000X000000		00X1
100000 X00  00X00001
1X000X000 0000000 01
10X00000000000 00001
1000000	0XX00000	001
10000000 00000 0X001
11111111111111111111
