NO test_artifacts/valid.xpm
SO test_artifacts/valid.xpm
WE test_artifacts/valid.xpm
EA test_artifacts/valid.xpm
F 39,75,231
C 136,181,247

11111111111111111111
100 00 00000 00	0X	1
10000X0 X	0000 00001
10X00 0 0000 0 00001
1000000000 0000000 1
1  0	0  0X000X000001
100000000 0000000001
10000000000000 00001
1   	X000XX000000 01
100000000000000	00	1
1000000000 0X00 0X 1
1000 0 000 0000000X1
100 00000000	00 	X01
100 0 000 0 00X00001
10000000X00000000001
10X000 00	000XN	00X1
100X000 0X0	 0000001
1000	00000XX00X00001
100	000000X00 000001
11111111111111111111
