NO test_artifacts/valid.xpm
SO test_artifacts/valid.xpm
WE test_artifacts/valid.xpm
EA test_artifacts/valid.xpm
F 90,50,228
C 158,204,8

11111111111111111111
1	00000000X00000  01
10000 00000000000 01
1000 0 00		000XXX001
1X0X000XX 0X0000 	01
1000 	00X00 0X000001
10 	000X0000NX0X0	01
100	00000	0000000 X1
100000XX00X0 0000	01
10X	X00000	00	00	001
1000X00	00000 0000X1
1 	0	0X000  X0000001
10X0000000	0000X0001
100000 000000000 001
1000	0XXX 000	00	001
1X00000 000000	00X	1
100000 000000X	00XX1
10000000000000 00001
1XX0 000000000X00001
11111111111111111111
