NO test_artifacts/valid.xpm
SO test_artifacts/valid.xpm
WE test_artifacts/valid.xpm
EA test_artifacts/valid.xpm
F 97,133,120
C 193,82,249

11111111111111111111
100000000000X00 0X01
10000000000X00 0 0 1
100	 X000 0000000X	1
1X0000X	0  000000X01
100X XX00 X00000X001
100X00 000000 00	001
1X0 00000000X0000001
10000 000X	X00000	 1
1	0000X000 000X0 0 1
10X0X 00 0 00X0 0XX1
1000000X0000X00XX 01
1000X00N0X00X00X 001
10000	0000000X0 0001
10 X0000X0 0XX000001
100	 0 00X0000 XX001
1000000000X	  00	0 1
1000000000	X0	   001
1000X0X00000000 0001
11111111111111111111
