NO test_artifacts/valid.xpm
SO test_artifacts/valid.xpm
WE test_artifacts/valid.xpm
EA test_artifacts/valid.xpm
F 189,182,0
C 54,254,20

11111111111111111111
1 000000000000000X	1
10X000	000000 00 	01
10 000000000000X0 01
100X0000000 0	X0N0	1
10 000 000000000	0X1
1	X0000X0000X0000001
100000X00000000 0 01
100	0X00X 0 0000X001
100000000000000000X1
100000 0000000X 0001
1000	00000000   0001
100 0	000 00000  0X1
1 0	000X00000 00	001
1X0	0XX000X00000X001
1000 000000000X00	01
10000000000X0000 0 1
1	000000 0000 X 	0 1
10000XX00000	X0X0001
11111111111111111111
