NO test_artifacts/valid.xpm
SO test_artifacts/valid.xpm
WE test_artifacts/valid.xpm
EA test_artifacts/valid.xpm
F 212,193,182
C 205,10,173

11111111111111111111
1000	0000000000 0 01
1000000 0 00000000 1
1000 00 000 0X000001
1X0X00000 0 	 00X 01
1 0000XX0000	X0000X1
10000X0 00X000000001
1000000000000X X00X1
1X000000X0X0X0	X0001
10X0 000X00X000 0001
10	000X00000000000 1
1000 	0	000	00X000 1
10000X000  000000001
1 00000	0000X 0000X1
1X00X0000 0000XXX0 1
1000000 X00000000001
1	0XN0	000000000 0 1
100000000000000 0 01
1	00	00		000000 0001
11111111111111111111
