NO test_artifacts/valid.xpm
SO test_artifacts/valid.xpm
WE test_artifacts/valid.xpm
EA test_artifacts/valid.xpm
F 48,51,67
C 168,76,212

11111111111111111111
1000 0000X00000X0001
1000 0000XX0000	00	1
10000	00 0XXX0000001
1000000000	X00 00001
1	000	0000000X00 001
1	00	0	XX00000000	01
100000000	XX00000X01
100X0X 000000000X001
100X0000000000000001
10 X0000000	0X00X 01
10000 XXX	0000000001
1X000000 000X000XX01
100 	 000	X000 0X001
100	0000X00000000001
10N0000	000 00000X01
100	XX0 0000000X0001
10000000000000000001
100X0X000000000000X1
11111111111111111111
