NO test_artifacts/valid.xpm
SO test_artifacts/valid.xpm
WE test_artifacts/valid.xpm
EA test_artifacts/valid.xpm
F 6,201,88
C 30,149,23

11111111111111111111
10000001010000000001
10000000000010000001
110001000N0000100101
11000000000000110101
10000100001010001101
10000100000000000111
10001000000100000001
10000001100000001101
11100100100000101101
11000000100000000101
10000010000100000011
10011001000010100101
10000000000000000001
10001110000000000011
10011111000000010001
10001000011000011001
10001000000000000001
11111000000000101011
11111111111111111111
