NO test_artifacts/valid.xpm
SO test_artifacts/valid.xpm
WE test_artifacts/valid.xpm
EA test_artifacts/valid.xpm
F 143,0,0
C 84,71,190

11111111111111111111
10 00000 00000000001
10X0000000	00000XX 1
10000	0000	0X0000001
100000	0 00000000001
10000 00X0X000	00001
1XN	000	000XX  00001
1000000X 000000000	1
10X00000000000X X001
100 000000000X00	0X1
1X00000000000000  01
100	00000000 000X001
1000 	000 00X0 00001
10000000X	00000   01
10  0X X0000X0 X0X01
1X0X00000000 0000001
1000	000 00	 	00   1
100XX0000X000 00X001
100	X 00 	000 0000X1
11111111111111111111
