NO test_artifacts/valid.xpm
SO test_artifacts/valid.xpm
WE test_artifacts/valid.xpm
EA test_artifacts/valid.xpm
F 203,115,209
C 208,128,44

11111111111111111111
10000001110110000001
10001000000111110011
11000000010010100011
11000100000000001101
10000000000010000001
10011010100000000001
10000000000000000001
10000000000001101001
10010000000110000001
1001000N000000011101
10000100000100000001
10001000000100001001
10000010000010000001
10001001001000000001
11101101000010000001
10000000000100000001
10001001000001001001
11000001000001100001
11111111111111111111
