NO test_artifacts/valid.xpm
SO test_artifacts/valid.xpm
WE test_artifacts/valid.xpm
EA test_artifacts/valid.xpm
F 195,0,0
C 107,157,201

11111111111111111111
1000000000 00	0X0001
10	00000X0XX0X0X0001
10000 00 000000 X001
10000000X000000		001
100000000000 0X 0001
10000000	0	X0 00X001
10XX000000X000000001
1000 0 X000000	00X01
10 000 X000	0	00 0X1
100	X 0X00X0 000 001
100000	0X00X XX00001
1X00X00000000 000001
1000000000000000N001
1000X0000000000000	1
10X  000000000000 01
1000X00 000000000001
100	X0  0000 0000001
10000 00000X00X00001
11111111111111111111
