NO test_artifacts/valid.xpm
SO test_artifacts/valid.xpm
WE test_artifacts/valid.xpm
EA test_artifacts/valid.xpm
F 8,62,159
C 89,6,42

11111111111111111111
10001000000001000001
10011000000000000011
10100100000000011001
11110000000001100101
10000100000100010001
10000100000000000101
10001100000001100001
10001000000000000101
10000110000100000001
10000000100000000001
10101101100101000001
11000000101010000001
10000000000001010001
1100000N000000001001
10000000000001010011
11001000000000011001
10011001010000100011
11001000000000011001
11111111111111111111
