NO test_artifacts/valid.xpm
SO test_artifacts/valid.xpm
WE test_artifacts/valid.xpm
EA test_artifacts/valid.xpm
F 246,155,227
C 94,12,168

11111111111111111111
10110001001000000011
10000000100011000011
10100000100001000001
10001101100011100001
10000000000100001001
11000000000001001001
10010000000011000001
10000101001110000001
11000001001111000001
10000000011001100001
10110001000000111111
10000000000000000001
100010110010100N0001
10000000000000000101
11001000010000001101
10000010011000001001
10010001000001011001
10001000000011000001
11111111111111111111
