NO test_artifacts/valid.xpm
SO test_artifacts/valid.xpm
WE test_artifacts/valid.xpm
EA test_artifacts/valid.xpm
F 101,90,44
C 4,91,148

11111111111111111111
10000X 	000000000001
10000	0X000X00000	01
1X00 0		0000000	X0X1
10X0 000XX0 00 00001
100 0000000	00	X00X1
1000  0	0000XXX00X 1
1XX X0XX000X	00000 1
100000 X0 00 X	00  1
100000000N000 0X0 01
10X0000 00 00X	00 01
1 00X00X0  0000X0001
1000X0000X00 	00 0X1
100X00000	0  0 00	X1
100 00000	000 0	00X1
1000000000X00000X0	1
1X0000X000X00  00X01
10000X XX00	00 0X 01
10X000	00 X0X0000001
11111111111111111111
