NO test_artifacts/valid.xpm
SO test_artifacts/valid.xpm
WE test_artifacts/valid.xpm
EA test_artifacts/valid.xpm
F 53,59,246
C 102,216,187

11111111111111111111
1000000	00000 000	01
1	X 0000 00000000001
10000	X00X000 	 X001
100 00000000	00X0001
100000 0000X	00000	1
10000000000  	  X001
1000000 000000X0X001
1X	000XX0	0000X00  1
1	X0000X0 0000000001
10000 00000	0X000001
1000 00X0000000X0	 1
1 00 000X00000000 01
10 00  	 	00000	0001
100X000N0X0X0000 0X1
1X00X0000 	00000 0X1
1000000XX00000XX0001
10 X00	  000 0X 0001
1 0000000X0 0X0000 1
11111111111111111111
