NO test_artifacts/valid.xpm
SO test_artifacts/valid.xpm
WE test_artifacts/valid.xpm
EA test_artifacts/valid.xpm
F 3,2,255
C 128,10,55

11111111111111111111
1X000 X0000	 0X00001
10X000	0000X0X 00001
10 00000000 0X00X001
1000000	00000 000001
1000X00  0X0000 00 1
10	00000	000000000 1
1 000000X000000000 1
1000000000000  0X 01
1	XXXX0000000	000001
1	X00 00 0XX0X000001
1 000000000XX0000001
1 00000X0X0000000001
10	00X0	0000 0000X 1
10 0X	00X 000X00	001
10000	000000 0	 0001
1000X0 000X000000001
1X00 X00000000XN 001
10 0X 0	000000X00001
11111111111111111111
