NO test_artifacts/valid.xpm
SO test_artifacts/valid.xpm
WE test_artifacts/valid.xpm
EA test_artifacts/valid.xpm
F 47,145,143
C 213,61,180

11111111111111111111
10000100010000001001
11100010000000000001
10100000001000011001
10000000001100101001
100N0000011000000011
11000000010000000001
10101001000100100101
11001010000111010001
11000010000000100001
10000100100100000001
10101010000010010001
11001110010000100011
10000000010010000001
10001101000010000001
10010000100000000111
10001010001000000001
10000001011000000001
11110000000010001001
11111111111111111111
