NO test_artifacts/valid.xpm
SO test_artifacts/valid.xpm
WE test_artifacts/valid.xpm
EA test_artifacts/valid.xpm
F 180,254,4
C 16,223,217

11111111111111111111
1000000000N00 00 	01
1000000 0	0000X 0001
1X00000000000000	001
1000000000  0	0000	1
1 0XX 00X0X0X0X	0001
1	0	00	000X0 000	0 1
10000X00 00	0000X0X1
1X00 0	0000	00000 01
100X0X00X0000000X0X1
100	00000  000000001
1000000X000 00000	01
1 00000000000X0 0 X1
100X000	0 0 	 000X	1
1 00000 0	000000 001
1000000  XXX00 00001
100	00000 00000000 1
100	 0 00X	0 0000 01
1000000XX 	0000 00X1
11111111111111111111
