NO test_artifacts/valid.xpm
SO test_artifacts/valid.xpm
WE test_artifacts/valid.xpm
EA test_artifacts/valid.xpm
F 137,116,1
C 10,73,16

11111111111111111111
10000000000000010001
10000101000000000001
11111001001100000011
11100000000011000001
10000N00000000000001
11110001100010101001
10100011000000010001
10000000000000100101
10101110101000001001
10010001110100000001
11001110010101100001
10000100000010000001
10001000100000000001
10001010000100010001
10000010000000011101
11000010010001001001
10000000000000100001
10010011000000100001
11111111111111111111
