NO test_artifacts/valid.xpm
SO test_artifacts/valid.xpm
WE test_artifacts/valid.xpm
EA test_artifacts/valid.xpm
F 46,185,23
C 180,104,209

11111111111111111111
1	000 0N000000000001
10 0  XX000X00000001
1000000000000X000001
1 0X0000000 00000X01
100000000000000X0001
10X	000000	 0000X001
1000 00X00	0	 000001
1X0	 0X000000 0 0001
1X000X00X	0 0X00X001
100	000		0 0000000	1
1XX 000 X00000	 0 01
1 00	0 0000X0000	001
10000 0000 0 0000	01
10X00000000000X0	 01
1000 0X000X000 00X 1
100X00	00000 0000001
10X0000000 000000001
1  00 0 00  0X00X  1
11111111111111111111
