NO test_artifacts/valid.xpm
SO test_artifacts/valid.xpm
WE test_artifacts/valid.xpm
EA test_artifacts/valid.xpm
F 137,174,236
C 29,16,127

11111111111111111111
10000000000000X00001
10000000000000X00001
1	00X000X000X0000	 1
100000000000000	0001
100	0 00 00 0			0001
1 000000	X000 0000 1
1X00	NX00X00	0000001
10000 X 0  000000001
100000000 0	00000001
100	000000X0 0X0 X 1
10000X00X	0	000 0001
1X000000X000000	0 01
1XX0X0 00000 X	X0X01
1 000	00000 000X00 1
1X 0000000000	X00001
10000X00000X00000001
10000000 00 0000 0X1
1 000000X X 000X0	 1
11111111111111111111
