NO test_artifacts/valid.xpm
SO test_artifacts/valid.xpm
WE test_artifacts/valid.xpm
EA test_artifacts/valid.xpm
F 26,49,34
C 252,182,230

11111111111111111111
1000 0 000000 0X0001
1  0 0000X00 0000001
1000000000X0000000X1
100 00 X00X000000001
1000000000000N0	0001
100000X00 00X 0	 	01
1 X000000 000000 X01
10X00000000000000001
10000	 00X00	00 0	01
100 00X0000000000 01
100 00000000X	0000	1
1000	00XX00000000 X1
10X0000000	000000001
100000 X000   0000	1
1	00000 00000000 001
10 0000X00X0X00000	1
10000000000000000 01
1000X00X 0000X000001
11111111111111111111
