NO test_artifacts/valid.xpm
SO test_artifacts/valid.xpm
WE test_artifacts/valid.xpm
EA test_artifacts/valid.xpm
F 190,0,0
C 206,13,98

11111111111111111111
100000000 0	X00000X1
100X0	 X0XX 000000N1
10000 0X0X0X		0 X001
1 0000 0 0000X00X0X1
100X000X000X000000X1
1X000000X	0000X000X1
1X00000X 000X 000001
10000 0 0X0000000001
10	X0000000000X00001
1000 00000000000XX01
100X000	00000000	001
1X0000000X00000000X1
10	0X000 	0X0X00 001
1  0000000000X  0X01
10000000000000000001
100 00 	 0000000	001
10000000000X0 000	01
10000 X00 0	0	 00XX1
11111111111111111111
