NO test_artifacts/valid.xpm
SO test_artifacts/valid.xpm
WE test_artifacts/valid.xpm
EA test_artifacts/valid.xpm
F 241,80,186
C 139,243,91

11111111111111111111
10001000001000000001
10000001000000100001
10000000000100000001
10000100101000001001
10000000000000000011
10000010100010000001
10000000100000000011
10000001010000010001
10110000000000000001
10000000000000000101
10110001000000000001
11000100001000101001
10000000000111100101
101000N0000001001001
10010000000100010001
11001110000000100001
11000000000101000001
10000010000001010001
11111111111111111111
