NO test_artifacts/valid.xpm
SO test_artifacts/valid.xpm
WE test_artifacts/valid.xpm
EA test_artifacts/valid.xpm
F 107,79,48
C 194,93,233

11111111111111111111
1000X000 0 	00000001
10	X0X0 0000X00X0	01
10X00000000000000001
1	00 X000XX000000001
10  00000	00 0000001
1000X00 000	00000001
100000	00000000X0X 1
1000000000	00000 X01
10000X00000000000	01
10000000000000000001
10X0	00X00000 00X0 1
1000000X00000X000	 1
1	000X000000X0X00001
100 00 0X		00000X001
1000000000X0000 0001
10000X00000 000X00X1
1	X000 00000 000X001
10000 X  00NXX0XX0	1
11111111111111111111
