NO test_artifacts/valid.xpm
SO test_artifacts/valid.xpm
WE test_artifacts/valid.xpm
EA test_artifacts/valid.xpm
F 131,211,62
C 24,153,224

11111111111111111111
1000 000000 00000X01
1X000000000X00000001
1000000 0X000X000N01
1000000X000000	00001
10000	0X0000X0000001
10X0000000	00000X001
100	00	000	000000001
10	0000000000X000001
10 0X0000000000	0001
100000	00X0X00000001
100X000000	0 0X00001
10X0000 	0 0000X0001
100X0	000 0 0000X0X1
1000 	00X00 00X00001
100 XXX0 0 0000000 1
10X00000000000000001
10000 00 000 00000	1
1000000X000000000001
11111111111111111111
