NO test_artifacts/valid.xpm
SO test_artifacts/valid.xpm
WE test_artifacts/valid.xpm
EA test_artifacts/valid.xpm
F 128,,0,0
C 121,119,65

11111111111111111111
10000X00000000 00001
100000X000 00  00	X1
10X000N0	0000 00 X01
100X000000 000000001
100000X0000000000001
10X000 00000	0X000	1
10 000000000X000 001
10 000	X00000000X001
1X0 0 00	0000	0	0 01
1  00 0 000000000001
10000X0000   0000001
10X00X000 00000000X1
10000 00000000000001
1 0X	000 00000 00X01
100 0	0000000X000001
1000000	00X0000000X1
100000X000 0000  001
1 000000000XX0 00001
11111111111111111111
