NO test_artifacts/valid.xpm
SO test_artifacts/valid.xpm
WE test_artifacts/valid.xpm
EA test_artifacts/valid.xpm
F 132,123,56
C 236,218,179

11111111111111111111
10001010000000000101
10010001011010100001
10101100000000100001
10100000000010000N01
10000001000100000001
10000000010100000001
10010100000001110011
10010010000011010001
10000000000000000001
10000100000000011001
10100001100110010001
10101000000101000001
10001000010100000001
10000001110100000011
10000010000000100001
10010100000000000111
11000000010001001001
10000000001101001001
11111111111111111111
