NO test_artifacts/valid.xpm
SO test_artifacts/valid.xpm
WE test_artifacts/valid.xpm
EA test_artifacts/valid.xpm
F 186,0,0
C 21,32,197

11111111111111111111
100 000X  0X00000001
1X0000 0 00000000	01
1	000X00000000000X01
1 	00000 0000000 XX1
100 0	0X00000000X001
10	00XN00000X 000001
1000000X00000000X001
10000000  0000000001
1000X00000000000 001
1X0000 0000000000001
1000X 00 	000 000001
100 0 X000X00 0000 1
1 X	00	000X00000 X01
10X0000XX0X0000	0001
10000000 00000000X01
10000 000000X0000001
10000000000000000001
10X000000000000000 1
11111111111111111111
