NO test_artifacts/valid.xpm
SO test_artifacts/valid.xpm
WE test_artifacts/valid.xpm
EA test_artifacts/valid.xpm
F 92,94,91
C 49,151,187

11111111111111111111
10 XXX0000	XX0X0X001
1X00000 0X00000 00 1
100X00000    00 0	01
10000000000000000001
100000000	N00	XX00X1
10000  0000 000X0001
10X0X 0000000X000	01
10000000	00000000001
1	  0000  X 0000 001
10 000000		00X00 001
100000 0000000XX0 01
1000XX00 000	00000X1
10	00000000000X	0001
1 00 000000	X0000001
10000 00000000	0X001
1000000000 00000	001
10X000 0X0  0000X001
1 00000X0000X000 X01
11111111111111111111
