NO test_artifacts/valid.xpm
SO test_artifacts/valid.xpm
WE test_artifacts/valid.xpm
EA test_artifacts/valid.xpm
F 138,1,112
C 94,35,1

11111111111111111111
1000X0000000XXX	0001
1X00X0	00X000X0 00X1
1 000000 0XX0000X001
100000000 00000000X1
1000000	 0	0X0X00001
1000000 0 000000X001
10000 000000X00	 001
1X00X00X0 0X0000X001
1 00	000 	X000 00001
1   000000000X000001
10000 X X0X 00	00001
1X  X00	0 0	X0  0001
10000  0	 	000000001
100000 00X00000 X001
100000000XN000000001
1	0000X00 000	000X	1
10000 	0X0 000	00001
10000 000 X0000	X001
11111111111111111111
