NO test_artifacts/valid.xpm
SO test_artifacts/valid.xpm
WE test_artifacts/valid.xpm
EA test_artifacts/valid.xpm
F 47,174,247
C 88,146,180

11111111111111111111
1 0	0000X0X000000001
100000000000  000	01
1X0X00000000X 00 001
1XX00 00000X0X000 01
1 00000	X0 N 0000001
10000000X00 0	0   01
10000000X0000000X001
1 	0 000	000 00X 001
10 			XX00000	000X01
10	0000 0 00	00000 1
10X00000000	XX000001
10X00000  0000 0 001
1000000X000000X000	1
100X00000000 X0000 1
100000 XX000000  001
100	X00X00000X000 	1
10000000000000000001
1	X00X 000 	0  X0X	1
11111111111111111111
