NO test_artifacts/valid.xpm
SO test_artifacts/valid.xpm
WE test_artifacts/valid.xpm
EA test_artifacts/valid.xpm
F 255,18,171
C 47,136,195

11111111111111111111
1 00 000000 000 X001
10000 0000000X000X01
10 0	 00000000000 01
100  X	00000 0 000 1
10 0X 00000000 00	01
10000000X00 000 	001
1X000000X00000000001
10000000 000000X 001
1000X0000	000000 X01
100000000X00000X00	1
100X00000	0000000 01
10000000XX0	00000 01
10000	X00000 X000 X1
1X 000 X00000X00X0X1
10 000XX 00N00000001
100X0000000000	00001
100000 0 0000X000001
10000000 00000000001
11111111111111111111
