NO test_artifacts/valid.xpm
SO test_artifacts/valid.xpm
WE test_artifacts/valid.xpm
EA test_artifacts/valid.xpm
F 16,177,89
C 165,202,231

11111111111111111111
1000 00000000X000001
1000000 00 0	0  0X01
1	 0X000000000000001
100000 0000000000001
1XX00000 0 000000 01
1000000000X000XX0001
10000 00 0X00000XX 1
1 000X0X0000000X0001
100	000000 0X0000001
1 0000000000000 00X1
1 0X 00X00		0NX00001
1X00X000	000 0 0  01
1000	0X000X0X 0000X1
1000 000000000000001
1X00 	0X00000 0000X1
10XX00000000000XX 01
1000000000 000000001
100000000 0000000001
11111111111111111111
