NO test_artifacts/valid.xpm
SO test_artifacts/valid.xpm
WE test_artifacts/valid.xpm
EA test_artifacts/valid.xpm
F 85,187,175
C 153,114,94

11111111111111111111
10	000 00X0X	00 0001
100 00	X0000XX0X0001
100000000000XX  0001
100000000000X000	001
10000X0	00000X 0X001
1000000000X0X0XX0001
10 0X0X000X 000 X 01
10000	X000000X	 0  1
1N0000000000000	0001
100	000X00000X	00001
100 X0 00000	00000X1
1X000	00000X00000001
10000000000 X0X000 1
1 000000X00000000001
100000 00000X0000001
1000000	0 000	000001
10X 0X000	000	000X 1
10000XX 0 X000X0  X1
11111111111111111111
