NO test_artifacts/valid.xpm
SO test_artifacts/valid.xpm
WE test_artifacts/valid.xpm
EA test_artifacts/valid.xpm
F 84,175,217
C 2,86,85

11111111111111111111
1 00	00000000000X001
10X0   00000 0000 01
10	00000	X000X0X0X01
1 00X000	0000 0000 1
1 000	000000X0000001
1 000		0000 00 0 0X1
100000	000 0000000 1
1X000 00X00 00 00X01
1	00000		00	0000XX01
10	0N00 	0 	000000	1
10000	XX0 00XX00 0	1
10X00000000	0X000001
1000 0000 00	0 X0001
100000000X00 0000 01
1	000X	0 0 000000001
1	0X000000X0 0000001
10000000000000 	00	1
1 000000000000X00 01
11111111111111111111
