NO test_artifacts/valid.xpm
SO test_artifacts/valid.xpm
WE test_artifacts/valid.xpm
EA test_artifacts/valid.xpm
F 5,,0,0
C 88,220,94

11111111111111111111
1		 0000000000000X01
1 X 00 0X000  0X0001
100 000 		000X000X	1
10X00000	X	0000 00X1
100000		000 X000X0 1
1000000N00XX0X00X001
1X00000X000000X00001
1 0000000X0000X00001
100X0X0000X0X00 00X1
1X0000000000 0  X001
10	00X 0 0 000000001
10000000X0XX0 000001
10000000000 X000 001
10000X000X00X00000	1
1X00000 000X0X000001
1	  0	000000 00	0001
1000 00000000	000001
100	0000000 00 000 1
11111111111111111111
