NO test_artifacts/valid.xpm
SO test_artifacts/valid.xpm
WE test_artifacts/valid.xpm
EA test_artifacts/valid.xpm
F 177,142,117
C 56,193,88

11111111111111111111
11110000000000100111
11010000000001000111
11100100110000011101
11110000000000000001
11100110000000000011
11000100010000000001
10000000100001000001
10000010000000101011
10001000001000000001
11001000000001101001
11010001000001011001
11000000000000010101
10100N00100000000101
10110000000001010001
10100100010000001001
10000010000000000101
10000000010000100011
10000010000000100001
11111111111111111111
