NO test_artifacts/valid.xpm
SO test_artifacts/valid.xpm
WE test_artifacts/valid.xpm
EA test_artifacts/valid.xpm
F 85,192,228
C 8,95,171

11111111111111111111
10 00 0 0000 0000001
1  XX00	000X000  001
1000X00000X0XX0000 1
100000000	000	000001
1000	0000000X00X0001
1	0  00 00000000	0X1
10000X 	00XX 000 0 1
10  0X0X000000 00X01
1000X0	000000  0 001
1X	000N000X	00000001
1  0000000000X00X 01
100X0000 X000000	001
100  0X00	0XX0000001
100000000	000		00001
100  0X0X00X0 00 001
10	0 0 X0XX000000001
10  000 0 0000000X	1
100000XX0000000000 1
11111111111111111111
