NO test_artifacts/valid.xpm
SO test_artifacts/valid.xpm
WE test_artifacts/valid.xpm
EA test_artifacts/valid.xpm
F 198,,0,0
C 225,157,143

11111111111111111111
10 00 	 000X00 000X1
10000 00000 00000	01
10000000 0 000000001
100 0X00000000000001
100XX000000000 000 1
100 00	0N 0000000 01
10	X0000000X 000X001
1X00XX000X0 000X0001
1000000X0000000X0001
10000 0 00000000 001
100000	 00 0000	00X1
1000000000 000000 01
100 0X000 	0000X0001
1000 0 000000  		001
10000	0 0000000000X1
100	0000 0000	000 01
1 000X000000X0 00X01
1000 X0000 000000 01
11111111111111111111
