NO test_artifacts/valid.xpm
SO test_artifacts/valid.xpm
WE test_artifacts/valid.xpm
EA test_artifacts/valid.xpm
F 246,250,180
C 146,155,107

11111111111111111111
10	 0X00000 0000 001
10000 0 0000  0000	1
1000X0X00 0000	X0001
1X00000X0  00 0	0001
100000X0000000000	01
100000 000	00N000 01
1	00	 X0000X  0X 0 1
100	000 00X0X00000	1
100 00000X0000XXX  1
10000 000 X000000001
1000000000X0	0000001
1	0000000000000 X0 1
10X00 X	0000X00X0 01
10X0000 000	0X0 	001
10000X00 0X000000001
1 0 0 0X000000X000 1
100000000000X000 001
1000 00 	0000X 00	01
11111111111111111111
