NO test_artifacts/valid.xpm
SO test_artifacts/valid.xpm
WE test_artifacts/valid.xpm
EA test_artifacts/valid.xpm
F 201,169,40
C 252,108,61

11111111111111111111
1000 0000XN	00X00	 1
100	000X000000000001
1X 0X000000000000001
1000XX000X	 0 00 001
1000000X00 000000001
10000  000 00000 0 1
1000X000X00	X00	XX01
10		000X000X00000X01
1000000000X00X000 01
1000	X00 0X00000	0X1
100000 0000000000001
100000000000000 0001
10 00 X000X00  00001
100000000000000X0X01
10000000	 0000000001
10000 000X00000X0001
1 00X	0000X0 000X001
100 0 000000X0000	01
11111111111111111111
