NO test_artifacts/valid.xpm
SO test_artifacts/valid.xpm
WE test_artifacts/valid.xpm
EA test_artifacts/valid.xpm
F 179,41,255
C 173,155,177

11111111111111111111
10	0 000X00 00XX0001
10X0 00	0XX00 000001
1XX00000X 00000 00X1
10 0	0000X0 000 0 01
100 0000X0000	000001
1 0X0	00X00000X 0001
1	0000XX00X0X0  0XX1
1	0X00	00X0000X 00X1
100 00 000	0	000X001
100 0X0 XX000XXX  X1
1 X000000 00	0X	0X01
100N000000XX00	00001
1000000	000000 X0001
1000 00X0	 000000 01
1	X 0000000X00000001
1 000X 00 00000000X1
1 000000000000000001
1X00000X 00000	00001
11111111111111111111
