NO test_artifacts/valid.xpm
SO test_artifacts/valid.xpm
WE test_artifacts/valid.xpm
EA test_artifacts/valid.xpm
F 196,46,127
C 139,144,69

11111111111111111111
1000000000000X0000 1
1	00 00X000	0	000001
1 0000000X0000000001
10000	X00	00 0X	0	01
100X0000000 00X00	01
1X0X000X 0000 	0X X1
100X000X000	0000X001
1 0	0N0	 X00 0 0X0	1
1000000000000000X001
100000	0000	0X000001
10	X0000X00000 	X001
10X000 	0 0000000001
1000X0X	00 	000000X1
10000X000000X0000001
1 000000000	0000X0X1
1000000000		0000  01
100 000X0000000 0001
100	00X0000000X 0001
11111111111111111111
