NO test_artifacts/valid.xpm
SO test_artifacts/valid.xpm
WE test_artifacts/valid.xpm
EA test_artifacts/valid.xpm
F 141,92,128
C 249,84,149

11111111111111111111
10000011110000001101
10000100100001000001
10000001001101100001
10000000100010001011
10000110100001000001
10101000000001000011
11100001000000100001
10000111000001001011
10000100000001001101
10111010000100101001
10000000000000000001
10000000001000010101
100000N0000000010001
10000000100001010001
10010001000000000001
10011101001100001001
11010000001000000111
10100010000100000001
11111111111111111111
