NO test_artifacts/valid.xpm
SO test_artifacts/valid.xpm
WE test_artifacts/valid.xpm
EA test_artifacts/valid.xpm
F 11,0,0
C 30,64,85

11111111111111111111
1XX	0000000000000001
1X00 00000000 000001
100X000	X00000 00001
10000000000000000X01
1000000X0X00	0X 0001
100X0 0000	 0000X001
100000000	0  00X0X 1
100 00000 0 000	0	 1
10  0	000000000X0001
10X00	X	000 000X0001
10 X00 0000X00 00001
1N00000X000 0000	  1
1X0000	X0X0000X00001
1000 0X0X	0000X0X001
100000000 00000X	001
10000X00X0XX00000001
1000X000	0XX00 00001
1000000X0	00000000	1
11111111111111111111
