NO test_artifacts/valid.xpm
SO test_artifacts/valid.xpm
WE test_artifacts/valid.xpm
EA test_artifacts/valid.xpm
F 293,0,0
C 28,23,4

11111111111111111111
1000XX0 0000X0000001
10X	0000000X0	00N001
1000000 000	 0000001
1000 0000000 X000X01
1000X00000 00000 001
10 X 000000X000	0001
1000X000XX0000000001
10 0000 000000000001
100  000000000000	 1
100 000XX 	000000 01
10000	0000000000X001
1000000000XX0 0000X1
10 000	X00X000 00001
10X  0X00000X00XX001
1X00000000 00X00	001
1X00 0000 000	0000 1
100	 0  00000 	 0X01
1000 000X00000X0 001
11111111111111111111
