NO test_artifacts/valid.xpm
SO test_artifacts/valid.xpm
WE test_artifacts/valid.xpm
EA test_artifacts/valid.xpm
F 149,224,102
C 44,118,127

11111111111111111111
1X0 	X 00X00 0X00001
100000000000000 00 1
1 00000  0 0000000 1
100000000 00X0 X0001
1X0000000000000 0 01
10000 0000X000X00001
100 0000 0XX000000	1
1000000000 0  0 0	01
1000000X000000000001
100XX 00000000 	0001
10X0 00X0 0000000001
10000X00 00000  0001
1000 X00N0000000X001
1000XX000X00 0000	X1
1000X 00X000XXX00X01
100000000XX000000	X1
10X0X000X00 0 000 01
10X00X000 	00X 0	001
11111111111111111111
