NO test_artifacts/valid.xpm
SO test_artifacts/valid.xpm
WE test_artifacts/valid.xpm
EA test_artifacts/valid.xpm
F 253,18,132
C 93,117,141

11111111111111111111
10011000010001000011
10000001000001001011
10000000000001000001
11100001101000001101
10100000010000000011
10000000001000000001
10000000000010N00001
10000000000000001001
10000101001000010001
11000001010000001111
10000010001010000011
10000100000100010001
11010001000000000011
10011010100101000001
10001100001100101111
10010000000000000011
10101000001011000001
10101100000100000011
11111111111111111111
