NO test_artifacts/valid.xpm
SO test_artifacts/valid.xpm
WE test_artifacts/valid.xpm
EA test_artifacts/valid.xpm
F 13,243,231
C 199,158,192

11111111111111111111
10000X000		0000	00 1
10000000X0  00 0X0 1
1000X0N0X0 X000X 001
10000000000000000001
100X0000	000000 0001
10000X	 00X0	00000X1
10		000000000 000001
100000000X0000000001
100X000000 000000001
10000 	00		0000 0XX1
1X000000	X000 000001
1000000	000000 00	01
10X 0000 00000X00001
1X 00 00000X0 000001
10  0000 	00X000X0X1
100000000000X0000X01
1 00	 000X00 0	0	0 1
1 X00X0000X00X	0X0 1
11111111111111111111
