NO test_artifacts/valid.xpm
SO test_artifacts/valid.xpm
WE test_artifacts/valid.xpm
EA test_artifacts/valid.xpm
F 158,205,199
C 119,111,31

11111111111111111111
1000 0 00X00X0X00001
10000X00X 000000X001
10000 00	0 00X0000 1
100X 00XX000000X 001
1000N0   000XX00X 01
10X000X00X00X0 0 001
100X0 000X00X00	0001
10000000X00X 000X001
1000000000X00000 001
100 00000000000 0001
1	00000	000	00000001
1X0 0000X0	000000001
10  0 00000	0 X00001
1000000	00  0	000001
1 X0X000X0X00000X001
10000XX0000 0 000X01
1XX000000000000XX001
10000000	00000000001
11111111111111111111
