NO test_artifacts/valid.xpm
SO test_artifacts/valid.xpm
WE test_artifacts/valid.xpm
EA test_artifacts/valid.xpm
F 141,212,6
C 142,238,73

11111111111111111111
10100000000000001001
11001000000010000001
10100010110010010101
10000100000000000001
10000100000010000001
10011000000001100001
10000000000011000001
10000000000011000001
10010010000001000111
10000101010000100001
10000000000000000101
10000000000000000011
10001000100001000001
10000011000N00000101
11010100000000000101
11111010001011000111
10100000100100100001
10000000000010100011
11111111111111111111
