NO test_artifacts/valid.xpm
SO test_artifacts/valid.xpm
WE test_artifacts/valid.xpm
EA test_artifacts/valid.xpm
F 76,227,120
C 49,252,243

11111111111111111111
100 00 0	000000XX001
1000 00 	00 X00	X 01
1 00000000XX000X	0X1
100 000000 0	000	001
10	0000X000	 0000X01
1 0 0X000000	00 XX01
10N000 	00	0 0 00001
1X00000 00XX000XX001
10X0X000XX0 0XX00001
1000	00000000000 001
10 X000000  000X0001
10000000 00000X00001
1000000000X000000001
10 X000X 00 00 00001
1   00000X000 X00001
1	0 00000000 X 000X1
1X000000 0	 00000 01
1 00000000000000X	01
11111111111111111111
