NO test_artifacts/valid.xpm
SO test_artifacts/valid.xpm
WE test_artifacts/valid.xpm
EA test_artifacts/valid.xpm
F 13,,0,0
C 53,79,9

11111111111111111111
1000000 00	0	00000X1
1 0 0	0 00X0X00	X001
100X0000000N0	0  001
1 00000X0X0 0 0	  01
100000 00000000X0001
10000  00000000X0001
1000000X000X00000  1
1	0X0000000000000001
1	0 X 0X00 0X000 001
10X0000000 00 000001
10000 0	00XX00  	001
10000000X00000000001
10000 0 00 000000X01
10 0000X0X00000000 1
100000X000000	 00001
100 X X0X000000X0001
1 00	000	0X0	0000001
100  0X00	000 0000	1
11111111111111111111
