NO test_artifacts/valid.xpm
SO test_artifacts/valid.xpm
WE test_artifacts/valid.xpm
EA test_artifacts/valid.xpm
F 157,115,5
C 201,165,229

11111111111111111111
100000 0 000000000	1
100X00000000 00 0 01
10X00XX0000000000001
1000X00 000	X0000 01
100XX00 000000000001
100000 00000000	00X1
1X000000000000X 0001
1000	X00X00NX X00001
10 00 X0000  0000 01
1XX0X0X0000000000001
10 0000X 0000000	001
1000X00X00  00000001
1000	00 000	0X00	001
100X 0 	000 000	0001
100 00000	0000000001
1	00 	000XX0	0 000X1
1000X0X00 0000X00001
100000 0000X00000001
11111111111111111111
