NO test_artifacts/valid.xpm
SO test_artifacts/valid.xpm
WE test_artifacts/valid.xpm
EA test_artifacts/valid.xpm
F 183,3,242
C 207,219,206

11111111111111111111
1 X00 0X000000000	01
10X 000X	00000X00001
10000X000 	0X00000	1
10X00000X000	X0 0X01
1000000000  0	000001
10	X00000X0X0X00	 01
1 0X 00000000	0 0001
100XX000 000XX0 00	1
10000	X00X0X00000001
10		00X0000 X0000001
100000000000000000 1
100 000 000	00000X01
1	000000000000000001
1XX 0000	0000 N	0 01
100000 0000	00000XX1
100000	00000000X0001
100 00  000		0000 01
100000    	0X0000001
11111111111111111111
