NO test_artifacts/valid.xpm
SO test_artifacts/valid.xpm
WE test_artifacts/valid.xpm
EA test_artifacts/valid.xpm
F 85,78,7
C 80,2,26

11111111111111111111
10000100000000001011
10000000001000001001
10000110000000100101
10100000110000010001
10100010100000000011
10001100000101001001
10000000010000000011
10100000000000000001
10001000000000010N01
10110000000010010001
10010000000100000001
10111000000100010111
10000000000000001101
10000000100000000011
10100000000000000111
10000101000000010001
10000110000100000001
10001001000000010001
11111111111111111111
