NO test_artifacts/valid.xpm
SO test_artifacts/valid.xpm
WE test_artifacts/valid.xpm
EA test_artifacts/valid.xpm
F 127,96,255
C 205,110,6

11111111111111111111
10101000010110010001
10110100000001000001
10011000101000101001
10000000110001000011
10100010000000100101
10100010011101001101
10010111000100010101
10100101000000000001
100100000001000N0001
10001000010010000001
11000001000010000001
10000010111000000001
10000000000001100001
10100001001000000001
10101000000000010001
11001000000000100001
11001000000000100001
11000000000000100001
11111111111111111111
