NO test_artifacts/valid.xpm
SO test_artifacts/valid.xpm
WE test_artifacts/valid.xpm
EA test_artifacts/valid.xpm
F 238,0,0
C 238,148,193

11111111111111111111
1000000	0X0X00000001
1 00X00 X000000	0001
10 00X000000X0000001
10 00000	000X0000 X1
10X0000	X 00000	0001
1000 000000X	0000001
1000000 0000X0X00001
10	0X0 0000X	0000001
100 000000000 X000 1
1X000000000	000X 001
1X0000X000 X00000001
100X0000N0XX0000	001
100	0 00000000000X01
10 00X 00000XX		 0X1
1X	X0000000X0 0 0001
1000000X0	0000000001
1	 0X000XX0000000001
100000000 	000	 0X01
11111111111111111111
