NO test_artifacts/valid.xpm
SO test_artifacts/valid.xpm
WE test_artifacts/valid.xpm
EA test_artifacts/valid.xpm
F 116,251,135
C 32,224,74

11111111111111111111
100000 0X0	 	0000001
100 00000	000000 001
10000000000 0000X0	1
1000000000X0000	0001
10 000000X	 00000X01
10 000000	0000000 01
1000XX000000X0000001
100	0X000X0X 00 0001
100 0XX0 000X00000X1
1 	0 00X00000 000001
10 000000000 0000 01
100X0X 000 00000X001
1000000000000X000001
100000X0X00000000	01
1000 0000X0 X 000001
10000	 000 X000 X001
1000 000NX0X0 000001
100000 000X00000X001
11111111111111111111
