NO test_artifacts/valid.xpm
SO test_artifacts/valid.xpm
WE test_artifacts/valid.xpm
EA test_artifacts/valid.xpm
F 179,44,18
C 119,189,130

11111111111111111111
10000000 X0X00000001
10 000	0X0000000 001
100X0000000XX 0000	1
1000000 00 000	00001
1000000X0 000 000001
100	000000  0	 00001
1 X0 00 0 000XX		001
1  00000000 000000 1
1X0000000X	0X	0000X1
10000000N00000000001
10000	000 X0 0 X0001
10000 00000 00000	01
100 00000000  0000X1
1 	0 0 0	X0000000001
1 0X000000000000XX	1
100000000	0000 00001
1000X000000000000001
1	000000X	00000X0001
11111111111111111111
