NO test_artifacts/valid.xpm
SO test_artifacts/valid.xpm
WE test_artifacts/valid.xpm
EA test_artifacts/valid.xpm
F 144,169,209
C 89,81,196

11111111111111111111
10010010010010000001
10010001000100000001
10000010000011001001
10000000001000100111
10001001101010000001
11000001000001000001
11000010100100000001
10110100000000000101
10000000000100000011
10000000010001011001
10000000001100001001
10000000000000000001
1011000000N000011001
10000000000000100001
10000100000100000001
10000000000000000001
11110001100001000001
10000010000000010101
11111111111111111111
