NO test_artifacts/valid.xpm
SO test_artifacts/valid.xpm
WE test_artifacts/valid.xpm
EA test_artifacts/valid.xpm
F 43,237,203
C 11,208,52

11111111111111111111
10100001000110000001
10000100011000010011
11000000011000001011
10000000011000100101
11001100100000000101
10010000110010000001
11000100010000000001
10000100100000100101
11000110000000000001
1010010000N000000001
10110001000011000001
10000000000010000111
10000000000100000001
10100000000000010001
11000100100100110001
11010000000000000101
10011010000011000011
10010100100010100001
11111111111111111111
