NO test_artifacts/valid.xpm
SO test_artifacts/valid.xpm
WE test_artifacts/valid.xpm
EA test_artifacts/valid.xpm
F 162,130,253
C 146,5,6

11111111111111111111
10	0000X0X0000000001
1	000 00X0	0 000X 01
10000000000 00	X00X1
1000 0X 00 	0000X001
10 000 0000000000001
100000000X0X	 X0	001
10000 00 0X000000001
1000000X00 00X000X01
10X0	0000	000 0 		01
10	XX00X0000	0X00 01
1X 00000000000 0X0 1
1X000		 XX00000  001
10X00  0000000000	01
1 00000 0000000X0 01
100	0 0000 0X0000	01
1 X	0000 00X	00X0001
100000000000	000X001
10N0 00000X000000 01
11111111111111111111
