NO test_artifacts/valid.xpm
SO test_artifacts/valid.xpm
WE test_artifacts/valid.xpm
EA test_artifacts/valid.xpm
F 87,0,0
C 29,159,182

11111111111111111111
100X00	 000000000001
1X0X000X00X000000001
1000 0 00X 00X0N0X01
100 0 00	0 00 0 0X01
100000000 00 0000001
1000 0000000 0 00X01
10000X 000X000 000 1
1X000000X	000X00X001
100 X000000000XX0 X1
10	0000X	0000	00 001
1X000	00X0	 0X000 01
10	0000000000X 0 001
1 X 	0000X00X0000001
10	00X0000	00 000 01
1000	00000	0000  0X1
1000	0 	0 0000X00001
1X0X0000000000000001
1000X000000 	X 00001
11111111111111111111
