NO test_artifacts/valid.xpm
SO test_artifacts/valid.xpm
WE test_artifacts/valid.xpm
EA test_artifacts/valid.xpm
F 202,195,11
C 190,246,74

11111111111111111111
100 00000X	X00X0 0X1
100000000 0000000	01
1 00	X00000000X00001
1000000000000000 0X1
100000  0 0 00000X01
100000 00000000X	001
1 00		 000 000000001
1000000000 00 000	01
1X000X00000000000 01
10 000 0X 0 00000001
1 0 N00XX0X000000X 1
100 00	000000	0 0001
100X0000000 00000 01
1000 000 000000X0001
100000000X00000X0001
1000000 000 0	0 0001
10X0000 00X0000 0001
1000000  00X00000001
11111111111111111111
