NO test_artifacts/valid.xpm
SO test_artifacts/valid.xpm
WE test_artifacts/valid.xpm
EA test_artifacts/valid.xpm
F 234,87,197
C 89,101,162

11111111111111111111
10000 00XX 00 X0X0 1
10000X000 000 00 001
1000 0		000000000001
1000	00 X000000000	1
10000000000000	000 1
1000 00000 00X0X0001
10 0X 00X000 000 001
1000 000X0X0 XX0 001
1 00X000000000000001
10000X0000000 000001
1X0	0 0X0000 XX0X	01
1000X0000X000000 001
10000000 0X000000 01
10000  000X000000X01
1000000X0 0000000001
1000X000 0	000000001
10	0000 000X0000X0X1
100X000000X 00 N00X1
11111111111111111111
