NO test_artifacts/valid.xpm
SO test_artifacts/valid.xpm
WE test_artifacts/valid.xpm
EA test_artifacts/valid.xpm
F 159,52,209
C 251,240,87

11111111111111111111
10X0000	0 X000	X 001
100	0000000000	00	 1
100X0000	 	00N0X0001
1000 00X0000 0000 01
1 00000 0 00	0000  1
10000000X	00 0 00001
10000X000 00 X000001
100000	00X0000000	X1
100X0X	 0 000X 00001
100 00	0	0000X 00001
1000 000	0000X0 0001
100	000	0000000XX001
10000000X000000X0001
1000000		00000000001
1 	0 000000X0	0	0001
10 0X0000 	 00000001
10	X00000	0000000001
10000X0000000X0	0001
11111111111111111111
