NO test_artifacts/valid.xpm
SO test_artifacts/valid.xpm
WE test_artifacts/valid.xpm
EA test_artifacts/valid.xpm
F 31,167,239
C 28,40,190

11111111111111111111
1X0000000X0000000001
1000000000000	00XXX1
100	00000000	00000X1
100X00000X00000000 1
1X0000000000000 0 01
1000000X 000	00 0001
10000000000000000001
100X 00X 00XX0X00 01
100000	00X000X0X00X1
1 00X00 0000000000X1
1N 000 X0 X0X0000	01
10X 0X00000X00000	01
1X000X00 000X0000001
10000000000000 X	001
1000 00X0000 0000001
100X00000	0000XX0001
1000 000X00X00 00 01
1 X0000	00000X000001
11111111111111111111
