NO test_artifacts/valid.xpm
SO test_artifacts/valid.xpm
WE test_artifacts/valid.xpm
EA test_artifacts/valid.xpm
F 38,168,232
C 255,232,17

11111111111111111111
1 0 0X0  	0	00000001
100000X00X00000 0001
100X 00X00 000 0X001
100 000000000 0 	0	1
1000 0 000X00	00 001
1X0000X0X00 0X	00	01
10000 00000 0 000001
10X000000X0X00000	01
10000X0X00	0000000	1
100000X0X000000000 1
10	 000 0 0X00X  001
1 00X00 000 00000001
10  00 00 0000000001
1000X000000	00000001
1000000	 000000X0001
10000 000	X 00000N01
1000 000X000000X0 X1
1000000X0 0X0 0X0	X1
11111111111111111111
