NO test_artifacts/valid.xpm
SO test_artifacts/valid.xpm
WE test_artifacts/valid.xpm
EA test_artifacts/valid.xpm
F 189,126,191
C 77,163,2

11111111111111111111
100000	0 0000		00	01
100000000000  000 	1
10 0000	00 0  0X0001
1000	0X000X000000001
1 00 00X00000X00 0X1
1000  00X000X 00X001
10000X000	000	000001
100000 00 00X0000001
10000X00	0000	000 X1
10 0000000	 000	0X 1
1	X000	000	00 0000 1
10	   XX0000	0		0001
10000X0	00 0X0000		1
100X0 00X 00000000X1
10XX0000000	000000X1
1 00000000	0000000X1
1000X0N0 00 X0	00	01
100000 0000XX0000001
11111111111111111111
