NO test_artifacts/valid.xpm
SO test_artifacts/valid.xpm
WE test_artifacts/valid.xpm
EA test_artifacts/valid.xpm
F 18,0,0
C 86,190,8

11111111111111111111
1000	00 000000000001
100 00000 000X000	X1
1  00000000	0000 	01
100000X000 0000 X0	1
10000000X0000000 001
1 000000000000X 00	1
10000000N0	 00X 	0X1
10000000000000000001
10X0 0 X00 0	0	00001
1X0000 000000000 001
1000X00000X00 00  01
1000	X00 00XX00000 1
1000000	0 0	000000X1
1000000X 00X000000X1
100	000 00X0X0000001
1 	0 000	00  00	0 01
10000000	 	000000001
100000X000 000000001
11111111111111111111
