NO test_artifacts/valid.xpm
SO test_artifacts/valid.xpm
WE test_artifacts/valid.xpm
EA test_artifacts/valid.xpm
F 73,54,76
C 163,81,34

11111111111111111111
10110000001010000001
10000000000000001001
10100001001000000011
10000101010000010001
10010000000010000001
11010100000000000011
10010001000000100101
10000000101100000011
10000100000000001011
10001101100000000001
10010001000100000001
10000000101001000111
10000000000000011111
1011111000N010000101
10000010100001101001
10000010000000011011
10000110000010000001
11000000010000001001
11111111111111111111
