NO test_artifacts/valid.xpm
SO test_artifacts/valid.xpm
WE test_artifacts/valid.xpm
EA test_artifacts/valid.xpm
F 264,0,0
C 82,167,14

11111111111111111111
10X00X0000X0 XX00001
100000X0000	0000X0X1
10000 0000 000000 01
10X0000  00X00000001
1000000N 000 0000 01
100000 00000000 0X01
1000000	0X0000000001
10000 	00000  0X00	1
10X	 0X0000X00X0X001
100000	0000000000001
1000X 00X00X00000001
10 0		0000000XXX 001
1X0X000X	X	0 X 0X	01
10  00	000000	 00X01
1X	00X00	0000000 X01
10X0000000 000X00X01
1  0 X0000000	00XX01
1	0X 0 00000000000X1
11111111111111111111
