NO test_artifacts/valid.xpm
SO test_artifacts/valid.xpm
WE test_artifacts/valid.xpm
EA test_artifacts/valid.xpm
F 68,57,240
C 249,111,213

11111111111111111111
100 000X000 00X00001
1000	  000X0X0000001
10 000000000000000 1
1 00000X00 		000	001
1X0N0000X00000000001
100 0000	00 00000	01
10	000000000 0000001
1000X 00000000 0	001
1X000000XX00X0X000X1
100000000000 0X00001
1 0 0X0000000X0X0001
100X00000  0X0	0 001
1000 0  0X000000X001
1 000000000000 00 01
100X000000000000 001
1000	 00000X00000 01
1X0000000 X	00000001
10000 0000000000 001
11111111111111111111
