NO test_artifacts/valid.xpm
SO test_artifacts/valid.xpm
WE test_artifacts/valid.xpm
EA test_artifacts/valid.xpm
F 218,54,28
C 215,108,123

11111111111111111111
100000000 0000000001
10000000000X 00 00 1
100 	0000000XX000001
1	0000000 00	0 00001
1XX 00X0000 00000X01
10 00	00X00000000 01
1X0X00000	X000000001
1000000000000 0	0001
10 00X00000000X000N1
100X 0 X0000X	000001
1  0000X0	000X000X01
1000		00 00000000001
1 X00X000 X000000001
10 0 0X00000000X00X1
1X0000 000 000X0X0X1
10000	000000	00	0001
10000  X00000 000001
10000X0 00000	X0		01
11111111111111111111
