NO test_artifacts/valid.xpm
SO test_artifacts/valid.xpm
WE test_artifacts/valid.xpm
EA test_artifacts/valid.xpm
F 54,208,87
C 79,243,172

11111111111111111111
10 0X000N00000000X01
1000000	00000 X 0X01
10XX0	0 000 00 00X01
100X0X0000000000	001
1 000X0 0 0 X00X00 1
100000 000X000000001
1XX000000000 0000 01
10 0000000 	00000X01
100X000 X0XXX	000  1
10X0000000000000 001
1 00X0000 000X0X0001
100000X0 000	X00	 01
1 00000000 000 	0001
1 00 0X0   0	0 00001
1000000000000 000001
10	0XX0X 0 00000X001
1	0  000 000000000X1
10000	0000 	0X 00001
11111111111111111111
