NO test_artifacts/valid.xpm
SO test_artifacts/valid.xpm
WE test_artifacts/valid.xpm
EA test_artifacts/valid.xpm
F 52,37,15
C 246,158,216

11111111111111111111
1000 000000000X00 01
100000000000 0000 01
100  0	000	000000001
10000X00 00X0X000001
1000000 00X000 	0001
10 X	0 00000000 00X1
1   XX0X00 00	000X01
1 00000X	00	X00000X1
10000X 	00X	0	X	 XX1
1 000X0X0X0000000001
1000	 000X0000000001
10000000X0X000	00001
10X0000000X000	00001
1X00 0	 0000XX000001
100X0X00 X00	0X00001
10000000000X00000001
10N00000	00 00  0 01
10 00X00000 0 000001
11111111111111111111
