NO test_artifacts/valid.xpm
SO test_artifacts/valid.xpm
WE test_artifacts/valid.xpm
EA test_artifacts/valid.xpm
F 17,145,40
C 201,144,40

11111111111111111111
100 000	0	 000000001
100000000 00X00 0001
1000000000X0000000X1
10 0000	000X0X X	 01
100000	0X	0 00 000X1
10 0  000000 0000001
100 0X0 000 X0000001
10000 X	 	00000X0 01
1X 00000 00X000XX001
1N0X00000000000 0001
1000	000   000XX0001
10000000X0  X00 	001
1 	000000 0	00000	X1
100000000X000000 001
1	00 00X00000  000X1
1X000000000	0 0000 1
100000000	0000000001
1 0  0000000000X0001
11111111111111111111
