NO test_artifacts/valid.xpm
SO test_artifacts/valid.xpm
WE test_artifacts/valid.xpm
EA test_artifacts/valid.xpm
F 103,121,72
C 213,86,103

11111111111111111111
11001010000000000001
10000001110011000001
10000000000000000001
10101000000101100001
10000000000001101001
10000000000000000001
11000100100001010001
10101000000000001001
10000000000100000001
10101000001000100001
110000N0000010100001
10001000000000010001
10110101001000111001
10001000000000000001
10000001000000000001
10101001000010000001
10000110010000000001
10010001010000000101
11111111111111111111
