NO test_artifacts/valid.xpm
SO test_artifacts/valid.xpm
WE test_artifacts/valid.xpm
EA test_artifacts/valid.xpm
F 198,,0,0
C 56,185,253

11111111111111111111
1 00XX00X0	00 0000 1
10000	00000000000001
1 0000000 	0 00X 0 1
10 00 	00 00000 0001
1X000000X00000000001
10000000000X00000001
1000X00	0000000X0001
1000 X000 0X000	0001
1X00000  00	0X0 0001
1	0000000000 N	00001
1X X00000X	00	0000 1
1X0 0	00000000000XX1
10000XX0000000 000	1
10X000	0 000X0 0	0X1
10	0X0X00000X00X00	1
10 0000000000000 X01
100000000 000 0 XX01
1000000X00000 X00001
11111111111111111111
