NO test_artifacts/valid.xpm
SO test_artifacts/valid.xpm
WE test_artifacts/valid.xpm
EA test_artifacts/valid.xpm
F 7,57,171
C 157,6,5

11111111111111111111
11101000000000000101
10100000000011000001
10110001100000110001
10001000000010100001
10N00000010000000011
10000010000000100001
10000001100100000001
11101000001010001011
10000000001001000001
10100010100000000101
10010000000000001001
10111110100001101101
10100000101000000001
10101000000000001001
10001000000000000001
10000010001001000101
10100001000011001001
10100000001000000011
11111111111111111111
