NO test_artifacts/valid.xpm
SO test_artifacts/valid.xpm
WE test_artifacts/valid.xpm
EA test_artifacts/valid.xpm
F 202,219,165
C 11,109,82

11111111111111111111
10000000010011000001
10000010001000000001
10000000011000000N01
10011000000000000001
11000001000000100001
10100000000100000111
10000000010000001001
11000000000101100111
11000100000000010001
11100100010010011001
10000000000000010001
11010100000000001001
10001000001110100001
10000101000100000001
10001100101100000001
10000001100000110001
10001010000011000001
10000100110001001101
11111111111111111111
