NO test_artifacts/valid.xpm
SO test_artifacts/valid.xpm
WE test_artifacts/valid.xpm
EA test_artifacts/valid.xpm
F 106,120,242
C 142,102,71

11111111111111111111
100 00X00000	00 00X1
10000X000 0X	0 000X1
100X0000000 0 000  1
1X0000XX0X0X0 000 01
1000N 000	0000000001
1000000000X0000X0001
100 0  0000000 0 001
100000X000 000000X01
10XX0000000000 	0 01
100 	0X000X000 00001
10000	0 0X000000	001
10 X0000X X0 0XX00 1
100000000000000000X1
1000000000X0X 00	001
1000X000X 000  X00X1
10 0000 0000000	0001
1000X0 0  00 0000X01
10000000000000	XX001
11111111111111111111
