NO test_artifacts/valid.xpm
SO test_artifacts/valid.xpm
WE test_artifacts/valid.xpm
EA test_artifacts/valid.xpm
F 197,70,224
C 220,104,181

11111111111111111111
10101100010010001011
10001000000000000001
11001000100100000001
11000000001000001001
10010000101000011001
10001000000010001001
10000000000010111001
11000000100000000101
10100100110010001001
10000000010010011001
10000010100100101001
11010100111000010001
10100001001000001001
10000000001000000001
10000000100100000001
110N0100000000011101
10000101100100000001
10000000000100000001
11111111111111111111
