NO test_artifacts/valid.xpm
SO test_artifacts/valid.xpm
WE test_artifacts/valid.xpm
EA test_artifacts/valid.xpm
F 39,237,21
C 74,64,230

11111111111111111111
10001010000001011001
10001000001000100001
1100000100100000N001
10101010000101000001
10010000000100000011
10100000000010001001
10010000000000010011
10110000000010010101
10001000000000000001
10000100100000000001
10000011000110100001
10001100000100101011
10000000000000111001
11100001000000001001
10001010000100000001
10110001000001100001
10000010000000100001
10000000000000010001
11111111111111111111
