NO test_artifacts/valid.xpm
SO test_artifacts/valid.xpm
WE test_artifacts/valid.xpm
EA test_artifacts/valid.xpm
F 63,,0,0
C 40,116,220

11111111111111111111
10000 00X  00X000001
1X00XX0000X000000001
100X00000 0000000 01
10 00 0 0X0	0000X001
10X000	00000X00	X001
100X0X0 000000X	0001
1000	00 0000000	0001
100X0X0000X00 000X01
100X	000X00 00000001
10000X0X 0	00X000 01
1XX000XX00X000000001
1 0000 0X000000000X1
100	X000000000000001
1 000000X0 0000  X 1
1XX00  X0000000N0001
1X0000X000 0 0000001
100 00X00 0000000001
1X0000X000 000000001
11111111111111111111
