NO test_artifacts/valid.xpm
SO test_artifacts/valid.xpm
WE test_artifacts/valid.xpm
EA test_artifacts/valid.xpm
F 191,245,31
C 59,228,125

11111111111111111111
10011100010000010001
10011000100100101001
10000000000001011101
10001000000000010001
11001000000000001001
10000001010000000001
10000001000000000011
10000000100101001001
10000000000010001001
10010000001000101001
10010000000001011001
1000000000N000100001
11000001000010101011
10000001000000000011
10000000000101000111
10000000010000000001
10100000000001000001
11000000000001110101
11111111111111111111
