NO test_artifacts/valid.xpm
SO test_artifacts/valid.xpm
WE test_artifacts/valid.xpm
EA test_artifacts/valid.xpm
F 43,104,237
C 180,86,83

11111111111111111111
1000 X00X	 X00000X01
100000000 00 000 0	1
1X0 X	00	X00000 0001
10 000000	000 000001
100 0X00	000 0000001
1	0000NX000000000001
10	 000000000000  01
1 0X00 000XX 0000001
10000 00		0000000001
10 X00X00X 000X00001
100 00 00000X	000001
1 00X  0X00X0  0XX01
10000000X00000000001
10000000000000000001
10 00X000000X00 00X1
1	0000	0000 0000 	01
10X00 00000000000001
10 000X00X00  000001
11111111111111111111
