NO test_artifacts/valid.xpm
SO test_artifacts/valid.xpm
WE test_artifacts/valid.xpm
EA test_artifacts/valid.xpm
F 192,184,175
C 152,224,145

11111111111111111111
10000010000001001011
10010100000001001001
10010100010100001001
10010000000110001011
10000000010000000011
10010001000000100001
10000010001010010011
10100001000000000001
10010100010101000001
10010000010010000001
10000010000000001011
11000000000N00001101
10000000010000001001
10000111001000000011
10010010001000000001
10001000000100010001
10000110000011010001
10000001100100000111
11111111111111111111
