NO test_artifacts/valid.xpm
SO test_artifacts/valid.xpm
WE test_artifacts/valid.xpm
EA test_artifacts/valid.xpm
F 143,158,152
C 191,213,210

11111111111111111111
10100000101010000011
10100010000001010001
10000101010001000001
10011001100010010101
10010000000001000101
10000000010011000001
10001010011001000001
11001000000010000111
10000010001101001001
10000100000001010001
10000000010000001001
10010000000100000111
10000000001001000001
10001110000001000N01
10000100000000010001
10000100100110100001
10000000000000000111
10010001010000100001
11111111111111111111
