NO test_artifacts/valid.xpm
SO test_artifacts/valid.xpm
WE test_artifacts/valid.xpm
EA test_artifacts/valid.xpm
F 188,249,200
C 64,244,99

11111111111111111111
10X	00	00 00	00X0001
100000000000 0000001
1000000XX000	0	0X0 1
1000000000	00000X001
10 0000000000 0 0001
100 00000000	00X0001
100000000X00000X0001
100000	X00000	000001
1000000	X0000 	00001
1 00X000 0 XX000X001
100000000000 0X	0001
100X0 00000 0X000 01
1000X0000000X 00 XN1
1000X 00 00X 0000001
10	0 000 00000 00001
1 000 XX0XX00X000001
1 0X0000000000000001
10	000 00000 0000	01
11111111111111111111
