NO test_artifacts/valid.xpm
SO test_artifacts/valid.xpm
WE test_artifacts/valid.xpm
EA test_artifacts/valid.xpm
F 156,7,237
C 230,176,56

11111111111111111111
10	00000	00 000	0N 1
100000000 000000	001
1X000000X000000000X1
1X00000000000 0000 1
1000 000000000000 01
1000000 0000	000X001
1	  00X00000000X0 01
1000000 0000 0000001
1000000000000 0 X001
10X000 00	00X0000001
100000000000000 0001
10000000X00000000001
1 00		00	000000000X1
1000000X00	00X0000 1
10 000000000 0000001
100000XX0 00X00 0001
10X000	00000 	0 00 1
1000000000 000000001
11111111111111111111
