NO test_artifacts/valid.xpm
SO test_artifacts/valid.xpm
WE test_artifacts/valid.xpm
EA test_artifacts/valid.xpm
F 213,26,210
C 203,236,36

11111111111111111111
10	0000	0000 00000 1
10X0000000	000000001
1X000 0		00000 	0001
1 0000 000	0000	00	1
1X000000000X0X000001
10000	00 	0000 00001
10	00000	0	0000X0  1
1 0 0 0 0000000000 1
10 00 X0000000000001
10000000 00X00XX 001
1000  00 0  00	 0001
1	0000000000	 000001
100X0000000 0000 001
1 0 00X	0	 0000X00X1
1X0 000 00X0 0 00  1
1000XX0XXX00000 0001
10000 0000 0 00000 1
100000	0N0 X00000001
11111111111111111111
