NO test_artifacts/valid.xpm
SO test_artifacts/valid.xpm
WE test_artifacts/valid.xpm
EA test_artifacts/valid.xpm
F 5,89,40
C 77,151,237

11111111111111111111
100000000000X0X000 1
10000 0X00	00 00X001
1 	 X0000 00 	0000 1
10000 000X00  000001
10 0 00  00000X000X1
10	00X000X0 00X00 01
100X0 000000000000 1
10X000000X 0  00X0X1
100000 X0	0 000 00	1
1	 000 0 00000000001
10000000 000000 0	01
100 0  0 00X00	0XNX1
10X0000000 0X 000001
10000000X0	00 000001
10000000X000  000001
1000 X X	0000  000 1
10	 000000000000 X01
100000 0000X000XX001
11111111111111111111
