NO test_artifacts/valid.xpm
SO test_artifacts/valid.xpm
WE test_artifacts/valid.xpm
EA test_artifacts/valid.xpm
F 159,,0,0
C 75,169,80

11111111111111111111
10000000000000000001
1000000 000000X	0001
100 00000X0	0000	001
100000X	0000000 X001
10000000	000000	X001
1 000000000X 0000	01
100N	 0000X00	000 01
1 000 0	00X0000000X1
1000 0000000 00X0001
1XX 0 000X 00000	001
100000X0	0 0	0 X0X01
10X0 00	0	0000000001
1X000	00 000X0000	01
100X0000X 00000 0 01
1 	00000000 0	00X	 1
100 0000000000000001
10	0 000 0000	0X00 1
1000 0 00000X0000001
11111111111111111111
