NO test_artifacts/valid.xpm
SO test_artifacts/valid.xpm
WE test_artifacts/valid.xpm
EA test_artifacts/valid.xpm
F 105,120,2
C 7,47,244

11111111111111111111
1	 0000	000X		0X0001
10 000XX000000XX0  1
1X0	00X00000   000	1
1000000 000 0		000	1
10000 000000 00XX001
100X00	0 0  X000X 01
1X000 00XX0	0X000001
10000000 000000 00	1
10	0 X00 00000000001
1X000XX0 00  00X0001
10 00 00000X00 00001
10	0N0 0000000000	01
1X00000 00000 X0	001
10000X00 000 0X000 1
10000	 000	0	0000	01
10 000	0 0 000X 00 1
1000 X0XX000X00000 1
10000	00000 00000001
11111111111111111111
