NO test_artifacts/valid.xpm
SO test_artifacts/valid.xpm
WE test_artifacts/valid.xpm
EA test_artifacts/valid.xpm
F 170,,0,0
C 246,70,239

11111111111111111111
100	00	000 00000 001
1000  00000000000001
1X0X0 000X00 0000001
1000000 0N000 0X	 X1
1X0 00 0000X00X00 01
10X00000000 00 00 01
1X0000000 		00X	0001
10 	000	0 0000000001
1X 0	00 000000000  1
10	 X000000 X 00	001
1000000 00000X000001
1 00 000000000000001
10000 	0	00 00000001
10	X0000000X000000 1
10000000000000000001
10X000000000000000 1
100000000X000000 001
100	0X0000XX	0000001
11111111111111111111
