NO test_artifacts/valid.xpm
SO test_artifacts/valid.xpm
WE test_artifacts/valid.xpm
EA test_artifacts/valid.xpm
F 50,2,176
C 217,248,42

11111111111111111111
10101010000000011001
10000001100000000001
11001011001010000111
10000110010100001001
11000010010011010001
10010010000000010011
10001000000000001001
10010001100000000101
11100001101101000001
10011100000000000001
10000000000001100001
10011000000000000001
10000001000N00000001
10100010100000001101
10001000010010010001
11000000000001011001
10011100010000000101
10000000100010001101
11111111111111111111
