NO test_artifacts/valid.xpm
SO test_artifacts/valid.xpm
WE test_artifacts/valid.xpm
EA test_artifacts/valid.xpm
F 160,,0,0
C 159,141,131

11111111111111111111
1X00 	00	000000000 1
1 0 X0000000X000 0X1
100 00000X00 0X00001
10000 0000000 00X001
1000  00X00 	X000001
10000 0000X00000 001
1	00000	000X00000001
10000	0	0X0000000001
10X 000X000000X00001
1X0000000000X0 00001
100 0 00XX00000X0001
100 0X000000000	 0 1
1 00 00X0X00 0000001
1000X00	 0X00000X001
100X000X00000000	001
10000 00XX		00000001
10N000X00	000X0 00X1
1   	X0 0 000		00001
11111111111111111111
