NO test_artifacts/valid.xpm
SO test_artifacts/valid.xpm
WE test_artifacts/valid.xpm
EA test_artifacts/valid.xpm
F 60,84,102
C 180,233,139

11111111111111111111
10000000010000000001
10000000100110001001
10N00000000000111001
10000110000110000001
10100011000010100101
10001010000000000001
10010010010000100001
10100010000000000101
10000010101010100101
11101100010000101001
10000011010000010001
10001000000000010001
10000100000000000001
11010100010001010011
10100000100000000101
10001100000000100001
10001010100000010011
11100000001010001011
11111111111111111111
