NO test_artifacts/valid.xpm
SO test_artifacts/valid.xpm
WE test_artifacts/valid.xpm
EA test_artifacts/valid.xpm
F 227,251,219
C 189,135,90

11111111111111111111
10X	00000X0000	00001
100000X0000000XX 001
1000XX00X0X000000001
1000X00 	X0X00	00X01
1000	 00X0	0XXX00	01
1 0000000 0X000 0001
10000	00000 000000X1
1000X0000X0000 00001
10000000X00000000001
100X00000000 000	001
10000XX00 0000X00001
1	0000X000	0 0 00001
100000 000 000000001
10 0000 0000X0X 0X	1
1	00000	0 0 0  XX001
1000000000	0   X0 01
10000 0 00	0000 0001
1X0X X0N000X000	 0 1
11111111111111111111
