NO test_artifacts/valid.xpm
SO test_artifacts/valid.xpm
WE test_artifacts/valid.xpm
EA test_artifacts/valid.xpm
F 66,139,243
C 216,40,246

11111111111111111111
1 000	 0 00N 000X 01
10 0	000000	  00X001
1000000		00000X00001
10000000000	00000001
1000	00X 0	0X00X0001
1X0X 00	00000X 00001
100 000000	0	 0	 001
100000000000	 000001
10X00X000 00000000	1
10	0 X00000 	0000	01
100X00000 0X00X000	1
10  0	000000000 X001
10000X  000000000001
1X 00X 0X0	000000 01
10 000XXX000000X0001
100000000X00	0000001
100000X000X00000 001
100X000000XX 0X00001
11111111111111111111
