NO test_artifacts/valid.xpm
SO test_artifacts/valid.xpm
WE test_artifacts/valid.xpm
EA test_artifacts/valid.xpm
F 191,196,21
C 234,77,184

11111111111111111111
10X0X00X 00	X000X0 1
100 00000 00XX0X0001
10 00		000 00X000001
1X0000000X0000000001
10X0000X 00	00000X01
1 0000	0000000000001
1000X0  0	000 000001
10 0 0000XX 0X0 00 1
10X00	  0 000000 0	1
1NX  000000000X00	X1
100	0000X00 0000 001
100000X 0000 0000001
10000	 X	000000X 0 1
10	000  00XX0  0X001
10	000000000000000X1
10000000X00	0 000001
10000000 0000XX00X01
10 0000000000000X001
11111111111111111111
