NO test_artifacts/valid.xpm
SO test_artifacts/valid.xpm
WE test_artifacts/valid.xpm
EA test_artifacts/valid.xpm
F 186,219,117
C 77,170,50

11111111111111111111
1000000 0000 0000	01
10 0X0N0 	0000000001
1000000000000  0X001
100000 0	00000000001
1	X 0 000 00000 0001
10X 0X0000000000X001
1X0000X00X00 00X0X01
100 0 00000000 000X1
100000X0	00 0 000X01
10000	X 00000 	00001
100000000000000	0001
1	0		000X00X0X00 	01
10000000000000000X01
1000	X0 000000000001
1 00X00000000 000	 1
10000000X00 000000 1
100	000000X00 0	 X01
10 0	 000000XX000X01
11111111111111111111
