NO test_artifacts/valid.xpm
SO test_artifacts/valid.xpm
WE test_artifacts/valid.xpm
EA test_artifacts/valid.xpm
F 58,69,197
C 226,231,78

11111111111111111111
100 00X00X0X0  X0001
1000000X0000000 0 01
100000 0000000000001
1000	000X  000000001
10 0 0	X000X000  001
1X00000X000000		00 1
1000	0000	0000 000X1
100000	0000000X0 001
10000000 X 00N000	 1
100 00X00X0 00000001
1XX000000000X0000001
1 0000 0000000000001
100000000 000	000 01
10 0000X0X000000	001
100 000000	000000001
10	0000 	00000000001
100 000000XXX0X	0 01
100000000 000	00 001
11111111111111111111
