NO test_artifacts/valid.xpm
SO test_artifacts/valid.xpm
WE test_artifacts/valid.xpm
EA test_artifacts/valid.xpm
F 122,120,109
C 54,58,84

11111111111111111111
1	X0000000	 000	0001
10X0	0000 000 0XX0 1
100 00000 	N 0000001
100000000X00X000 0 1
10 0000 0 	0000000X1
100X00000000 00 0001
1X00 00000000000	001
1	000000000000	00XX1
10 0 000 00 	0000001
100000000X0000000	01
1 00 0 000X000000 01
1000000000000000	 01
1000 X00	XX000 00001
1	00 000	 0 00X	0 01
1 000 00	0X00000 001
1 00 00000000	000001
10	0 0X00X00 0000X01
100XX000 00000000001
11111111111111111111
