NO test_artifacts/valid.xpm
SO test_artifacts/valid.xpm
WE test_artifacts/valid.xpm
EA test_artifacts/valid.xpm
F 89,196,248
C 112,79,120

11111111111111111111
10000100010100111001
10010000100000100001
10000010000010000011
10101000000000000001
10001000111100000101
10000110000010000001
11100000100000000001
10001001000010010111
10010101000001000001
11000000010000010011
10000000101000110001
10001000100000100001
10100101110N00000001
10000010100000010001
11010010000000011101
10001001000000101011
10000000010100000001
10001011000000000101
11111111111111111111
