NO test_artifacts/valid.xpm
SO test_artifacts/valid.xpm
WE test_artifacts/valid.xpm
EA test_artifacts/valid.xpm
F 242,,0,0
C 36,67,115

11111111111111111111
1 0000000000  000001
10X0000X0000XX000001
1	XX00000000	000 001
100000 0000X0 X00001
100	000000000X000X01
10	00 0XX00	00 00 01
10000X00X0000	 	 001
10000X000X00000000 1
10000XX0000X00		00X1
100	0000000000 0		01
1000 0X0 000 00000X1
10X	0 00000000000001
1000000 000	0000	001
1000  000 0000000 01
1000N 0 000	0 000001
1X000000X0X 00 0 0 1
10000 	000X0000X0X01
1 00 00000 0000XX001
11111111111111111111
