NO test_artifacts/valid.xpm
SO test_artifacts/valid.xpm
WE test_artifacts/valid.xpm
EA test_artifacts/valid.xpm
F 84,0,0
C 98,49,81

11111111111111111111
10000000000000 X0	01
10	000X000000000 001
1000000000000000X X1
10X0000000 000000001
100000000000	0000001
10000X000X00000 0001
100X000X000 0 000X01
1000000000	X00X00001
1X0000 000000 00X001
10 00	0000X000X000	1
10X00	00000000000001
10000		000000000 001
1000N000000000X00001
10000000000000  0001
1000X 000 00000 X001
10X0X00X0000000000 1
1 	0XX00000000000001
100X00 000X0X0X0 001
11111111111111111111
