NO test_artifacts/valid.xpm
SO test_artifacts/valid.xpm
WE test_artifacts/valid.xpm
EA test_artifacts/valid.xpm
F 136,139,19
C 49,218,175

11111111111111111111
10100000100000101001
10000010001010000001
10100000000100000011
10000000000000000101
10010000100000001001
10010001000011000001
10000000000000000101
10001000000101010001
10000011001000001101
10001010000000000101
10010000000100000001
10000000001000100101
10000011000000000001
10010101000001000001
10000000000001000101
11000N00000000000001
10000000000100000001
11010000010001000101
11111111111111111111
