NO test_artifacts/valid.xpm
SO test_artifacts/valid.xpm
WE test_artifacts/valid.xpm
EA test_artifacts/valid.xpm
F 79,55,160
C 140,12,224

11111111111111111111
10000010111000000001
10000000000010000001
10000011000010100111
10010000110010000001
10000100000010000011
10000000000010100001
10000000100100010001
11000000000010101001
11000010000001001001
10100000000000010001
101000010N0000100001
10011000000000001001
10000000000010100011
10001000100000000011
10110100000110110001
10100010001010000001
11100000000010000011
11011011000010000001
11111111111111111111
