NO test_artifacts/valid.xpm
SO test_artifacts/valid.xpm
WE test_artifacts/valid.xpm
EA test_artifacts/valid.xpm
F 158,187,103
C 187,106,25

11111111111111111111
100	 0	0 00  00X00 1
1000X 000X00 0X000 1
1000000	 00000000  1
1000 0000000000X0001
1000000000X0000000 1
1		N0  0000000000	01
1X00	00X000000	00001
100 000X0	0000X00	X1
100	0	000000000000X1
100000X000X	0	0	0X 1
1X00000000 0 0	X0001
1XX00000 X00 X 00X01
100000000 0000000X01
100X00000000 00		 01
1X00 00	000	00000	 1
10000		0	X0	000 0001
1X0X000 00X00 000001
100000X000 X00000001
11111111111111111111
