NO test_artifacts/valid.xpm
SO test_artifacts/valid.xpm
WE test_artifacts/valid.xpm
EA test_artifacts/valid.xpm
F 183,211,63
C 138,199,153

11111111111111111111
10		00  	000 0  0001
10000	X00000000X0001
1000 0X	0 000 00 001
10X0 	00		000X 00X	1
1000000000000000X001
100X	0000 X000000001
100000X	  00	00X0001
100	00X0X 000 0 0X 1
1 00000 00 00 000001
1X 00000000X0	000001
10000 0X0	0000000001
10000000 0X000000001
1X 0 00 0N0000000001
1X000X  00X0X0000001
10X0000000000000X001
100000X0000000000001
1 000 000000000000	1
1000 000	00000X00001
11111111111111111111
