NO test_artifacts/valid.xpm
SO test_artifacts/valid.xpm
WE test_artifacts/valid.xpm
EA test_artifacts/valid.xpm
F 213,52,255
C 5,134,41

11111111111111111111
10010000000001001101
11001000000101100101
10000110001000000001
11000000001001000001
10000000000000100001
100010001000N0000001
10000010000000010001
10000000000000010111
10001000001110011001
10001001100000000001
11010001000000000101
10001000011000001001
11000000000100011001
10100011110111001001
11010100000001000011
10100100001010010001
10000001000100100111
10111000001100001001
11111111111111111111
