NO test_artifacts/valid.xpm
SO test_artifacts/valid.xpm
WE test_artifacts/valid.xpm
EA test_artifacts/valid.xpm
F 53,42,217
C 144,57,172

11111111111111111111
100 X	00	000X0000001
10000000000X0X000001
100	000000X0000000 1
1000000000 X	0000 01
1 0 0 00000000	 0001
100X 0000 00X0 0 001
100 00000X0000	X00 1
1000XX0X000X0000	001
1000	000 X000XX00XX1
1000000000 0000	0001
1X00XX000XX0 0000001
1000 0X000XX00000001
1000 0X0	0 	0N000 	1
10 0 000000000X	0 01
100X 0	0000 00000  1
10 00 00000000000001
1000 	X0000000X 0001
1000X 000 XX	X	00001
11111111111111111111
