NO test_artifacts/valid.xpm
SO test_artifacts/valid.xpm
WE test_artifacts/valid.xpm
EA test_artifacts/valid.xpm
F 25,0,0
C 212,8,133

11111111111111111111
1000000X00XX00000001
10X00000X0000X00	 01
10000000 0X000000001
1X00XX000XX000 00 01
1X0000X00 0000000 01
100	 00 0 X 0 	000X1
10000X0 0  0000 0001
10000000000X00000001
10   000000X	X000001
1X  00X 0000X0000001
10X0	00X000000000001
1N0000X0 X000X	000 1
1X0  00X X0000000001
100 000 X000 0000001
1X000 0 000000000001
1000 00000X00000 001
1  000X00	0000 000X1
10 000X0X00 0X000001
11111111111111111111
