NO test_artifacts/valid.xpm
SO test_artifacts/valid.xpm
WE test_artifacts/valid.xpm
EA test_artifacts/valid.xpm
F 109,131,125
C 154,162,43

11111111111111111111
1 X00000X 0	00000001
1	00 000000	0000X0 1
10 	00X00000000000 1
10 00000X0000 000001
1X	00000000	00000001
100XX00X0000000 0 01
1 000X00000000 X0X01
1X 000 0 0000000 001
1000000 000000000001
10000X000000000000 1
1XX	 0000 N00	000001
1 0 00 00000000X0001
1000X00000000 00 001
1XX0000 000 0X00X001
10 000X0 00 000  0X1
100X0 	00 0000X00001
1 0 0000000000X00001
1000  00000000 00001
11111111111111111111
