NO test_artifacts/valid.xpm
SO test_artifacts/valid.xpm
WE test_artifacts/valid.xpm
EA test_artifacts/valid.xpm
F 213,0,0
C 213,227,154

11111111111111111111
100 000000X0000000 1
10000	00000000 00001
10 0X0X0  0X0	00 001
1000   XXX00 X000X01
10000 X000 0  X0X001
100X0000 0	0X 000001
10 000000000000X00X1
1 000 X0	00	X0X	00 1
100000X	0000000 0001
1000X0 00000	00 00X1
1000X00000	X00X0XX01
10000000X0XX		0000X1
10X X000000 00 00001
1X0X00000000 	 00001
1000 00000X0XXX0	  1
10000000000	00NX 001
10000000 00 0X00X001
10000000000000000001
11111111111111111111
