NO test_artifacts/valid.xpm
SO test_artifacts/valid.xpm
WE test_artifacts/valid.xpm
EA test_artifacts/valid.xpm
F 178,,0,0
C 175,113,124

11111111111111111111
1000X000000	0X000001
1X00 000 0 0 0  		01
1 0	X00X0 0000000001
100000X 000000NX0001
1	 000 X000000000001
1	0	000	000X X	00X01
1000X 00X000X00X0001
1 000000000000000001
1000	0000000000X0001
100  0XXX0X0 0 00 01
1000000 0X 0000X0001
100000X0	XX0 0 00001
1000X 	0 00	0 X0X001
10000	0X0	00X00XXXX1
100000 X 00000 00		1
100000XX 000X 0	0001
100000X  00000X00X01
100000X X0X00X0000 1
11111111111111111111
