NO assets/NORT-WALL.xpm
SO assets/SOUTH-WALL.xpm
WE assets/WEST-WALL.xpm
EA assets/EAST-WALL.xpm
F 123,124,3
C 200,200,200

111111111111111
111111000111111
111110000011111
1111000W0001111
11111110111111
111000000000111
110000000000111
11110111110000111111111
11111110000000000011
1110000100001111111111
111100000001111
111110000011111
111111000111111
111111111111111
